义演	benefit
最后	last
擤鼻声	sniff
上院	senate
哺乳动物	mammal
（蟹等的）钳	claw
[天]流星群的辐射点	radiant
圈	loop
律师	attorney	lawyer
蓓蕾	bud
钢铁工业	steel
传奇色彩	romance
期望	hope	prospect
圆	circle	round
少许	trait	inch
包打听	busy
[口]果盖	lid
菜牛（饲养以供肉食的牛）	beef
便士	penny
荒芜	waste
中心	centre	core	nucleus
肤色	color
叹气声	sigh
出生	birth
复合词	compound
美质	quality
（自行车或摩托车的）车座	saddle
（数量、价格、价值等的）增长	rise
东南地区	southeast
违法	error
城市	city
灾祸	evil
讲座	chair
进行曲	march
云	cloud
短处	shortcoming
井	pit
五	five
[化学]碳	carbon
齿弓	arch
千克	kilo
列车	train
无知	simplicity
[乐]（风琴等的）白键	natural
棒	bar
〈英〉管家	husband
赞同	consent
罗盘	compass
御座	throne
棚	shed	shelf
罪孽	sin
一把	lock
疲劳	fatigue
棉	cotton
声势	impetus
人	being	bird	creature	dust	human	mind	people	person	soul
玻璃罩	shade
起义	revolt
策略	counsel	device	maneuver	policy	strategy	tactic
（枪炮	training
（群体中）最聪明的人	brain
[逻]整体	universe
托辞	plea	pretext	stall	disguise	excuse
重要的事物	queen
（任何）大圆	equator
外人	foreigner
宗教节日	feast
（期刊的）特辑	feature
棉织物	cotton
国际公约	convention
机械等的）一套	gang
不同的性有不同的词尾等）	gender
一条（块）面包	loaf
这儿	then
抽屉	drawer
部长	minister
首席	top
（欲表达的）一点感情	bubble
歧视	prejudice
边框	frame
专题论文集	symposium
高级职员	officer	official
反对的理由	objection
建立	constitution	establishment	foundation	institution
雷达	radar
语句	expression
希望	desire	hope	odds	pleasure	possibility	promise
分开	division
浸泡液	steep
腊肠	sausage
明确	definition	clarity
擦亮剂	polish
圆形物	round
[韵]格律	metre
嗅觉	nose	scent	smell
反对者	opponent
联邦主义者	federal
互相关联的事物	reciprocal
嗣子	heir
药学	pharmacy
流线	streamline
债权	mortgage
（计算机）文档	document
错杂	complication
因素	factor	ingredient
庇护者	refuge
原稿	manuscript
（平分球形物体的面的）圆	equator
乐事	treat
赤褐色	bronze
（用于缝纫的）丝线	silk
[物理学]谱	spectrum
热病	fever
复合材料	composite
迷惑	fog
〈美俚〉税务官	revenue
高涨	soar
<美>毕业生	graduate
合成力	resultant
风俗志	customary
行贿	contract
〈古〉午夜	noon
[语言]辅音群	cluster
宣判	doom	sentence
刑事被告	prisoner
云幕高度	ceiling
分析	analysis
遗赠的财产	devise
药房	pharmacy	chemist
铁制品	iron
添入物（尤指一页印刷品图中插入或套印的小图）	insert
脚镣	iron
气喘	pant
农场主	farmer
卫星国	satellite
局势等）紧张	tension
悲痛	grief	sorrow	distress
署名	signature
[无线电]回波	echo
比例（尺）	scale
玻璃制品	glass
[军]猛攻	storm
几何学著作	geometry
最高分	possible
有影响力的人物	influential
有权威的书	bible
丢弃	discard
烟草制品	tobacco
反馈	feedback
部属	subordinate
对立的事物	other
文明	civilization
奥妙	depth
情节	argument
鞭子	lash	whip
生命	life
君主统治时期	reign
相似点	resemblance
电话窃听	tap
暴徒	bully	mob	tough
老富豪	jolly
来稿	contribution
[复数]当权者	authority
最高限度	ceiling	roof
飞机等的）大群	cloud
战争	battle	sword	war	warfare
（拉拉队鼓动运动员的）呼喊声	yell
宇宙机械论者	physicist
扩音器	amplifier	loudspeaker	microphone
流行音乐	pop
牲畜	animal
扳手	wrench
后卫	defence
跳伞	jump
雕像	statue
串联	series
枯燥无味的话	prose
几何平均	mean
（日、月等的）升起	rise
手帕	handkerchief
惊吓	fright	scare
教师	teacher
畸胎	monster
[橄榄球]长传	bomb
应唱圣歌	response
蘑菇状物	mushroom
[医]节律	rhythm
受愚弄的人	fool
负债情况	debt
趣味	interest
以某种方式待人的人	dealer
钻孔机	punch
实验室	lab
餐具盒	canteen
有	possession
月	month
触摸	feel	touch
（感情等的）爆发	hurricane
广度	width
优越（性）	superiority	advantage
（美国）东部地区的人	eastern
校长	president
资本主义（制度）	capitalism
突出的范例	beauty
配置	disposition
人行道	pavement	walk
南部人	southern
学院	school	academy	institute
[陆]二等兵	private
证券	bond	obligation
胡椒	pepper
进度表	schedule
侮辱	despite	slap	abuse	insult
宗教法官	ordinary
加农炮	cannon
相反	inverse
宣传者	missionary
[多用于英国]行李箱	boot
银河	galaxy
保证人	guarantee
（个人的）政见	politics
主人（尤指男性）	master
九十年代	ninety
细目	detail	particular	topic
〈美〉刻苦用功的学生	grind
（用砖石）铺（地）	pave
监禁	prison
展览	show	display	exhibit	exhibition
角度	viewpoint
一致	concert	consensus	correspondence	harmony	accord	accordance	agreement	coincidence
高原	plateau
企图	essay	shot
烧伤	burn
（工具	gang
三个一组	triple
号外	extra
弗赖伊（姓氏）	fry
货物	freight	goods	merchandise
度量标准	metric
度量衡标准	standard
古风	antique
现款	fund	ready
新观念	innovation
登陆处	hard
理论	theory
成衣工	tailor
大学的学生和教师	gown
一炉	batch
（货物的）一宗	parcel
〈比喻〉保护物	umbrella
敲平的人	flatter
洗发香波	shampoo
（人寿）保险	assurance
代替	replacement
夏天	summer
维修状态	repair
投递	delivery
飞机库	garage
残骸	remain	remains
（人或动物身上的）硬块	knot
舅父	uncle
摇摆不定的事态（或局面）	pendulum
（知识、兴趣等的）广泛	breadth
（动植物的）克隆	clone
提案人	sponsor
砖	brick
调羹	spoon
好的判断力	wisdom
银幕	screen
砌	opera
砍	chop
聚居人群	colony
[机]冲程	excursion
退去	exit
女侍者	waitress
工蚁	worker
精兵	effective
生计	bread	life	living	keep
打底	render
盐等的）颗粒	grain
脚步（声）	footstep
调查（表）	survey
灰烬	ash
（大学、银行等规模大的）机构	institution
具体物	concrete
（烟、云等的）圈状物	wreath
资料库	database
湮没	silence
侍者	attendant	waiter
棋	chess
润滑油	grease
茶杯托	saucer
吸入物	suck
[物理学]质量	mass
摇摆不定	stagger
斗篷	cape	cloak
继承顺序	succession
[美]大学概况一览	catalog
忠实伙伴	comrade
汽车	car	motor
屋面斜沟	valley
精髓	core	essence
熨斗	iron
妈妈	mother
房屋	building	housing	roof
储备	fund	reserve
（网球等）球拍	racket
收缩	shrink
查阅者	consultant
坏蛋	beast
[军]传令下士	orderly
极糟的食物	poison
十月	October
（像猫头鹰一样）机警的人	owl
（衣袖等的）腕部	wrist
弯腰	stoop
阴谋	conspiracy	scheme	intrigue
左	left
有极高智力的人	intellectual
指导	direction	guidance
女地主	landlady
闹铃	alarm
十五个人组成的橄榄球队	fifteen
计算机硬件	hardware
会合点	junction
侍从	bachelor	dependent
生产量	make
共和政体	republic
冒泡	bubble
进深	depth
比率	proportion	rate	ratio	relation
首领	boss	captain	chief	cock
潜随	stalk
[逻辑学]蕴涵	implication
著作家	author
道德心	conscience
排球（运动）	volleyball
管辖区	region
一块地	plot
纠葛	difficulty
起点	nucleus	origin	start
汽油	gas	gasoline	petrol
否认	contradiction	denial	no
怜悯心	bowel
愿望	desire	dream	mind
特别喜欢的人（或物）	favorite
[复数][美国口语]毫无价值的东西	bean
里面	within	inner	inside	interior
立法	legislation
海报	poster
咳嗽	cough
[军]炮台	battery
红衣主教	cardinal
乐队	band	music
社会生态学	ecology
慢跑	jog
灯泡	lamp
便利设施	convenience
鞭痕	whip
凉快的地方	cool
隔阂	wall
（钢琴等的）琴键	digital
（想像	riot
[建筑]屋顶排水沟	valley
生活的）途径	path
咬文嚼字	heroic
[地]岩颈	neck
（电台或电视）信息	transmission
轨道	orbit	rail	track
身材	shape
听觉	ear	hearing
谢意	gratitude
牛肉饼	hamburger
连接	conjunction	connection	join	junction
工厂]的工会代表	steward
惯以美妙的歌声引诱水手	siren
好运	joy	luck
[解剖学]肿块	bulb
液体喷雾	mist
[军]集合号	assembly
[天]双星中较小较暗的一个	secondary
论述	discourse
（总称）机器	machinery
战胜	defeat
〈口〉知晓	know
反论	paradox
宗复活节	Easter
法定权利	legal
骆驼	camel
产物	child	daughter	offspring
[语]原级形容词	positive
有瘾的人	addict
保护者	parent
同盟条约	alliance
夸张的言行	heroic
（可分类	particular
提及	mention	reference
吉他	guitar
论战	combat	controversy	war
窍门	wrinkle
美小手推车	wagon
学科	discipline	knowledge	school	science	subject
[电]分路迂徊	bypass
保险柜	safe
抨击	attack
系带	lace
[数]正量	positive
[生态]群落	community
铜管乐器	brass
装备	equipment	tackle
出口	outlet	access	exit	export
一杯或一份酒	drink
自选节目	voluntary
狐皮	fox
红外线	infrared
环形道	circuit
想像力	fancy	vision
交叉线	intersection
出发	offset
瀑布似的东西	waterfall
[语]比喻	comparison
救济品	salvation
继承物	heritage
选择能力	option
运弓法	bowing
储蓄	deposit
〈口〉精神	steam
公狗	dog
趾甲	nail
上当者	victim
成分	component	constituent
学业	school
钻子：一种钻凿用工具	bore
野餐郊游	picnic
梨（树）	pear
大减价	slaughter
幕布	curtain
[法]审讯	trial
修养	civilization	culture
（马车的）煞车	slipper
（军舰等）巡逻	cruise
最精彩的部分	highlight
土豆	potato
陆军少校	major
记入借方的款项	chalk
弓鳍鱼	hound
枕套	bag
全体员工	personnel
失窃案例	theft
分歧	gap	rent	split	gulf
出卖	sale
紫袍	purple
现象	phenomenon
愉快	cheer	pleasure
体验	taste	experience
拒绝接受	denial
（保险的）解约	surrender
术语	language	term
复述	rehearsal
某种模糊的或不清楚的东西	obscure
业务报酬	fee
英级限协定	threshold
自由主义者	liberal
袖套	sleeve
专题讨论会	symposium	workshop
〈口〉笔迹	fist
苍白	ash
立体声	stereo
平台	platform
嵌接	scarf
合作社	cooperative
王座	throne
经常重复的评价（或抱怨）	refrain
嘈杂声	noise	noisy	sound
坚决	resolution
肮脏	mess
比数	relation
水闸	lock
前额	brow
附件	enclosure	accessory
邮船	packet
油漆	painting
下期节目预告	underline
市场占有率	share
技艺	craft
一群罪犯	mob
[音乐]终止	fine
水平	level	plane
失事	wreck
壁橱	closet
高尔夫球	golf
三角板	triangle
巨兽	giant
碰运气的事	lottery
[信]信号瞬时值	sample
教士	clerk	clergy
（活动或能力的）余地	scope
（集工作、竞赛、娱乐为一体的）聚会	bee
资产	asset
狂奔	tear
灯心绒裤	cord
微小颗粒	molecule
[数学]度量	metric
弹丸	bullet	pill
皇后	queen
[宗]教徒	church
排练	rehearsal
少女	maid	adolescent
情感或感情	affection
天花板	ceiling	overhead
涌出	flush
防护罩	boot
弧线	curve
大国	power
兔子	rabbit
轻软舞鞋	pump
进攻	assault	attempt	offensive
黄褐色	tan
毛发	hair
防染剂	resist	resistant
马具	harness
期末考试	final
悬崖	cliff
力气	might
市]	strike
表示尊敬）大人	lord
翻倒	turnover	upset
坦白	admission
浮有冰淇淋的饮料	float
一百	hundred
胶接剂	cement
海运业	marine
网状物	network	web
色彩	color	paint
红色	blush	red
昏厥	faint
资历较深的	senior
油罐车	tanker
瞪眼	glare
推论	conclusion	consequence	inference
〈古〉旅客招待所	hospital
铅框	leading
剑术	fence
（书信或贺卡等中的）祝愿	wish
热带	tropic
木材	log	lumber	timber	wood
〈俚〉交通工具	bucket
鬼魂	presence
浓雾	soup
领导的才能或能力	leadership
尤指关上或断裂的声音)啪嗒声	snap
桶板	lag
学术报告会	symposium
猛仰头（尤指表示恼怒或不耐烦）	toss
静修	retreat
模糊想法	idea
食物柜	cupboard
民主主义	democracy
短暂的风暴	flaw
迷信行为	superstition
原因	reason	root	source	why	cause
风纪扣扣眼	eye
（精神	tension
友情	friendship
等级	bracket	chop	class	grade	rank	rate
河床	bed
遗物	survival
（一）套	set
黄铜	brass
参考书	reference
建造	construction
停止的位置	lie
大学	college
黄昏	dark	dusk	evening	sunset
无聊的事物	vanity
职业	business	career	employment	job	occupation	profession	vocation
（一笔）交易	deal	transaction
立方	cube
估计不足	underestimate
期限	term
接合处	join	joint	seam
接待	reception
桶	barrel	pail	tub
桨	oar
船队	fleet	navy
用作伪装的东西	disguise
体系	scheme	structure	system
有成功希望的人	hopeful
桥	bridge
环境判定	orientation
严重性	gravity
[棒]三垒安打	triple
无意义	absurd
冲压机	punch
正结果	end
幼儿	infant
年纪	year
（长篇）小说	novel
雄伟	majesty
跛行	limp
桃	peach
作曲	composition
讲师	reader
框	rim
预备品	reserve	spare
一茬植株	growth
农业生产	agriculture
〈口〉牌号	chop
英语字母表中第九个字幕	I
[航海]宽叶短桨	paddle
无聊的议论	prose
琐碎	detail
杂交品种	cross
拥护共和政体者	republican
丢弃的食物	garbage
直觉力	intuition
源泉	well
敌军	enemy
〈口〉有产者	have
强国	power
学士	bachelor
十九岁	nineteen
新颖小巧而价廉的物品	novelty
同等的人	peer
殖民地居民	colonial
[化]分馏	fraction
桡骨	radius
间断	break
演讲	lecture	speech	address
雷管	fuse
地球的半球	hemisphere
驴	donkey
克制	denial	restraint
对话体	dialog
先例	precedent	example
附录	appendix
选择（的自由）	option
碗	bowl
（常指供观赏的）花	bloom
测量	measure	survey
[植]菊科植物	composite
杰出的事	masterpiece
编造	fiction
马	horse
电报机	telegraph
适当的时机良机	opportunity
沙子	sand
构图	composition
被传授初步知识的人	initiate
激情	flame	glow	passion
少年（青年）时期	youth
[金融]承兑	acceptance
碰	touch
碾	grind
盒）	case
潜水	dive
正餐	dinner
[计]显示器	monitor
哑巴	mute
金额	sum
（大专院校的）助教	tutor
（色彩的）协调	accord
祖宗	ancestor
（某地的）沿革	history
〈非〉莽撞无礼	sauce
数学	maths
侨民	colony
五月	May
遗址	monument	remains	site
（尤指）内服药	medicine
淡味麦芽啤酒	mild
数字	digital	figure
灯饰	lantern
导言	introduction
山岳	mountain
美洲印第安武士	brave
舞弊案件	scandal
加法运算	add
盘旋	hover
漫游	travel
动身	start
[数]长方形	rectangle
相对性	relativity
干涸	dry
驱动程序	driver
[军]行军梯队	serial
尖酸刻薄	vinegar
（染色体上基因排列的）遗传图	map
（某些美国大学的）校长	chancellor
全部课程	curriculum
美政治贩	politician
选项	option
谈判	treaty
[语]冠词	article
感谢	gratitude	thank
首饰	jewelry
图案	design	device	pattern
后援组织	sponsor
学会会员	academic
干涉	interference
〈比喻〉不愉快的事	funeral
校订者	editor
马戏表演（常在大帐篷里进行）	circus
弓纬	bowing
阅读	read	reading
空想家	poet
一丝丝	hair
便签本	pad
繁忙的活动	rush
（质问等的）连发	torrent
最低消费	minimum
热闹场所	resort
擦布	cloth
扣留	retention
权衡	weigh
第三	third
香槟酒	champagne
[土木工程]腰槽	gain
牧羊人	shepherd
（病人受检查时躺的）长榻	couch
最大限度	most	utmost
平行线（面）	parallel
遗体	remain	remains
（工资以外）另行供给的膳食[住宿等]	found
访问者	visitor
男孩	boy
（一排）烟囱	stack
纪念仪式	memorial
原动力	motor
生物学	biology
手电筒	torch
爪形器具	claw
名流	celebrity	lion
口医学博士	physician
魔法	glamor	magic
强调成份	intensive
香水	perfume
有机体	organism
法律文件	instrument
着色	painting
摇动	shake
咖啡馆	cafe
伸展性	give
道德	morality
家畜	stock
酷爱	passion
殖民地	plantation
修订本	revise
畏缩	shrink
间隔	gap	space	interval
隆隆的响声	thunder
（艺术等）完整	unity
[数]交叠	overlap
经验丰富的人	veteran
肥料	fertilizer	soil
极限	limitation	margin	utmost
衣橱	wardrobe
与定冠词the连用	eternal
危害	harm	mischief
听力所及的距离	hearing
竞争者	competition	rival
妄想	bubble	obsession
（主教）邸宅	palace
班级	grade
深赤褐色	liver
百分之一	percent
[语]过去时	past
丢脸的人（或事）	disgrace
〈侮辱〉青蛙佬	frog
惊叹	awe
开价	offer
破门盗窃者	burglar
盟约	bond
有罪	guilt
社交	commerce	congress
地质学的著作	geology
微风	breeze
波浪等的）冲击	buffet
迁就	concession
爵士乐爱好者	cat
六月	June
混杂的事物[人群]	mixture
爆发	blaze	burst	flare	torrent	access	explosion	rash
痛恨	horror
劳务杂役	fatigue
小心	caution
通讯员	correspondent
同时存在	coincidence
种子	seed
浪花	spray
习俗	convention
起居室	living-room
粉红色的葡萄酒	rose
[航]节(=浬/小时)	knot
（吹奏乐器、哨子、汽车喇叭等突然发出的）响声	blast
旋转	revolution	twist	wheel	whirl
杯子	cup	mug
巡查	patrol
游民	tramp
古文明国的国民	ancient
个人简介	biography
挡风物	shade
锈	rust
减少	decrease	ebb	loss	reduction
峡谷	valley
锁	lock
偷盗	theft
锚	anchor
逻辑学	logic
被忽略的状态	neglect
减小	decrease
九月	September
人造肥料	artificial
控制板	panel
盎司	ounce
（用于某些国家的政党名称）国民大会	congress
更多	more
（膀胱或肾脏中的）结石	stone
推理小说	mystery
锡	tin
构架	framework
切望	anxiety
涂墙泥	plaster
衣物和装备	kit
（缝合伤口的）缝线	stitch
接受	embrace	acceptance
（社会）势力	force
物品	article
名誉	celebrity
练习	practice	exercise
美学标准	aesthetic
同“atone%27sworst.atone%27sworst”	worst
坚果	nut
上等产品	extra
会议记录	minute	proceeding
非晶体锆黑色	jargon
厌憎	dislike
口人类	christian
桨柄	loom
质量	quality
贷款	loan
棕榈树	palm
电力公司	generator
自动操作	automation
高手	artist	expert
（郊外的）新式住宅	cottage
依赖他人者	dependent
臭味	smell
出席	presence	attendance
船头	bow	bow	fore
免费邮寄权	frank
发觉	discovery
保健	health
倒退	reverse
歌曲	melody	song
不可思议的魔力	magic
[医学]消耗性疾病	consumption
弹夹	cassette
内行	sharp
烙印	brand
[乐]机理	mechanism
牲畜饲养	pasture
轻松的工作	picnic
取回	reclaim	retrieve
幽灵	ghost	shadow	soul
（尤指身体部位）凸起的形状	swell
礼服	dress	robe
无性繁殖系	clone
[数]单位数	unit
引言	introduction
营养	bread	nutrition
油布	waterproof
预习预习时间	preparation
（车辆或机器基座的）挡板	skirt
幻灯片	slide
读者	audience	audience	reader
周游	cruise
姑娘	bird	girl	bride
灶	oven
[语]反语法	irony
文字	letter
灰	ash
灯	lamp
敌对物	hostile
火	fire
[物]能量	energy
（教会的）权威	obedience
牺牲	blood	cost	sacrifice
智力	mind	intelligence
突出	emphasis
力量	might	muscle	power	strength	agency
烛光	candle
非传统（或他择性）生活方式的追随者（或鼓吹者）	alternative
主任	director
热度	heat
俚家畜	animal
监督者	director
车间	department	workshop
书目提要	bibliography
[乐]音阶	degree
坏话	tale
小人物	peanut	nobody
（物体的）飞行	flight
茶碟	saucer
所爱之物	love
[法]被监护人	pupil
前兆	beginning
谎话	lie
算术	arithmetic	figure	sum
这里	here
摇滚乐	rock
发育	vegetation
速记	shorthand
正态化	normalization
托盘	tray	waiter
[法]复审	review
方程式	equation
图画	drawing	picture
资本（私人占有和生产盈利）的支配地位	capitalism
机器的运转部份	machinery
非正式会员	associate
槽	chase
登	mount
胸腔	chest
[地质学]层	horizon
山谷	hollow	valley
药丸	pill
雪花	snow
剩余（或多余）的量	over
此刻	instant
表格	form
眉毛	brow	eyebrow
橡胶套鞋	rubber
一集	episode
棕黄色	tan
酱汁	sauce
友善	friendship
素描	sketch
胶料	size
欢迎	reception	salute	welcome
投影仪	projector
落潮	ebb
状况非常糟糕的车辆（或建筑物等）	wreck
（织机的）梭子	shuttle
（口语）烦恼	fry
饰针	pin
（指较远的人或事物）那	those
功课	homework	lesson
牛奶及乳品业	dairy
讨厌的东西（人	nuisance
信托	trust
外侨	alien
猎物	kill
不注意	absence
出席人数	attendance
君权	empire
办公用品	stationery
带电体	electric
少量	drop	handful	lick	pinch	somewhat	sprinkle	trifle	inch
雏形	prototype
断定	conclusion
突然发生	outbreak
公牛	bull	ox
冲撞	dash
油轮	tanker
引信	fuse
油画（布）	canvas
潜在性	possible
排放	release
扁板	paddle
根源	beginning	origin	parent	root	source
银鲤	bleak
推力	thrust	tug
俚及其可笑的事物	howl
螺栓	bolt
成功	joy	panic	prosperity	success	victory
勇气	courage	gut	nerve
出票人	drawer
[宗]主任牧师	dean
丑名	scandal
杂物	litter
屏风	screen
热恋	passion
物种	species
乐曲组合	mix
郊区	outskirts	suburb
成交量	turnover
干练的人	manager
（某地或某历史时期的）服装	costume
外国人	foreigner	alien
音乐家	musician
批评	criticism	exception
蠕虫	worm
旧时价值为一镑的英国金币	sovereign
（栖息在某地区的）动物	inhabitant
数因子	factor
游行	parade
未成年人	minor	pupil	infant
优势物种	dominant
巡回演出	tour
（搭档）演出短节目的演员	act
（车辆发动机的）阻风门	choke
小餐厅	cafe
旅客名单	manifest
本利之和	amount
气质	blood	habit	vein
配偶〔男女任何一方〕	mate
令人高兴的事	pleasure
令人愉快的事	cheer
附加物	appendix	plus	extra
接待处	reception
[造船]（打捞用的）浮筒	camel
宪法	constitution
（器官、皮肤、头发等的）移植	transplant
临时协定	interim
门廊	porch	stoop
平常话	commonplace
洗涤槽	sink
结束	close	ending	finish
专科学校	academy
航空器	aircraft
落锤	tilt
一段哭泣	weep
关于行路（或驾驶）的指示	steer
爆震声	knock
漠视	disregard
棒球（投手投出的）坏球	ball
保养	maintenance	keep
质朴	simplicity
更好者	better
尔虞我诈的环境	jungle
战略	strategy	tactic
顶点	climax	height	noon	pink	pole	summit	ultimate
批评家	critic
市政（或地方管理）服务机构	council
相遇	encounter
危险	danger	hazard	risk
意外的发现	revelation
估量	appraisal
增进	improvement
调节器	governor
炸弹	bomb
技巧	mechanism	skill	technique
仆人	servant
陆地	continent	earth	land
断食	fast
偿还数额	refund
美丽的事物	fair
血缘关系	relationship
王国	kingdom	realm
图下说明文字	underline
[电子学]触发器	trigger
妒忌	envy
台柱	pillar
装饰瓶	vase
奋斗	struggle
登机门	gate
精神包袱	baggage
准确（性）	precision	accuracy
调动	transfer
眼眶	orbit
（文学、戏剧）（情节、时间和地点的）统一性	unity
鸟语	song
[生]组织	tissue
用蒸汽工作的人	steamer
[计]输出信号	output
极度缺乏	famine
带子	strap	string	tape
研究会	workshop
大炮	cannon
椅子的背罩	tidy
猎狐运动（尤其英式英语）	meet
her等连用]（某人）所有的一切	all
候补者	alternate
独木舟	canoe
打算	notion	plan
点头同意	nod
未得分的投球	maiden
动词结构	verb
缝隙	crack
人性	humanity
性活动	sex
冬天	winter
（用于某些地名）圆形广场	circus
门第	kin
外科手术	surgery
[亦用复数][口语][通常用于否定结构]丝毫	bean
电烫发	permanent
（装在飞机上的）雷达电子干扰仪	carpet
复活节假期	Easter
特点	feature	flavor	particular	trait
机器助手	assist
社会	public	society
周相	phase
竞争	competition	struggle	tug
手提箱	briefcase
[复]口才	tongue
改变宗教信仰者	convert
（合成）橡胶	rubber
爬行动物	reptile
生产能力	capacity
矮木凳	cricket
复奏	repetition
被动语态	passive
油[水]箱	tank
细节	specific
螺旋状物	curl	screw
掠夺	rape	spoil
性	sex
支流	branch	affluent
舅妈	aunt
理事	director	manager	steward
幻灯机	projector
有…类型的血的	blood
皮革的）嵌接	scarf
几何学	geometry
愚蠢的事	sin
市价	currency
入场券	ticket
苛求	criticism
舆论	consensus
拉丁美洲人	Latin
法官	bench	judge	justice	ordinary
城镇居民	town
（尤指风的）呼啸声	moan
小屋	cottage	hut
沐浴	bath
信号机	telegraph
人口普查	census
全部含义	amount
威士忌酒	whisky
自找苦吃的人	victim
小山	hill
机活塞	piston
序列	sequence
头人	elder
四十几	forty
兴旺	health	prosperity	up
雌（象	cow
有遮盖的双人座椅	cosy
庄稼	plant
恋爱	romance
（学校、工厂等的）传达室	lodge
拱门	arch
同情	pity	sympathy	compassion
肘托	console
灵魂	soul
立体声系统	stereo
梯子	ladder
呐喊	shout
食道	canal	swallow
甜点	dessert
大学生	student	academic
脚本	script
全领域	universe
防备	precaution
回味（葡萄酒）	finish
透明	clarity
岩石	rock
名词性词	nominal
伴侣	company	associate
餐具	dish
重要性	consequence	gravity	matter	significance	value	import	importance
台词	word
红玉	ruby
传奇人物	legend
初步	alphabet
固定物	stationary
概率	chance	probability
[语]时	tense
民众	herd	mob	democracy
麦酒	beer
最适宜条件	optimum
售货棚	booth
大浪	surge
笑	laugh	laughter
笔	pen
砖块状物体	brick
非正式>性感的人	talent
标点	point
用力打	wipe
遮光器	shutter
细情	particular
（某事、戏剧、小说等的）背景	setting
吮吸	suck
[乐]基音	fundamental
耀眼	dazzle
地方法官	magistrate
生物	being	biology	creature	existence
[解]运动肌	motor
枕头	pillow
赘疣	tumour
仪表	clock	presence	style
石膏	plaster
下列	following
袜的）足尖部	toe
下一位	next
讨厌的人	bother
海关	custom
倡议者	sponsor
藏书楼	library
雌禽	hen
中央	middle
帐幕之物	curtain
（伤害的）赔偿	satisfaction
[乐]停止	silence
苍蝇	fly
最高纪录	record
峰	ridge
高飞	soar
服务员	servant	waiter	boy
提神物	refreshment
断枝	trash
停车场	park
否决票	no
口许多	heap
光	light
破坏手段	destruction
破产	crash	failure
回归线	tropic
后面	back
[动]世代交替的无性期的个体	nurse
烤	bake
可变因素	variable
小湖	mere
热	heat
辩护	defence
（报章杂志中的）文章	article
阅历	experience
焊接缝	shut
说法	phrase	version	expression
粮仓	barn
恐怖的缘由	terror
舰队	fleet
狮子	lion
（两党或多党）联合政府	coalition
纵队	column
于…类型的	type
工资	pay	wage
运货马车	cart
一世纪	century
有脚的架	horse
流通时间	currency
赌博	bet	play
清样	revise
原料	material	raw	stuff
安装	installation
猛长	jump
麦克风	microphone
[计算机]库管理程序	librarian
吃惊	startle	amaze
（对国家、地区、机构等的）管理权	control
新闻提要	headline
体温	temperature
烦扰	bother
肩膀	shoulder
消逝	glide
（比喻）飞快	gallop
定位	location	orientation
水罐	canteen
逗留	stay	visit
频繁性	frequency
争吵	argument	quarrel	static	strife	fuss
国民	citizen	country	nation
招贴画	poster
撞车事故	crash
竞卖	auction
居所	shelter
使人痴迷的人（或物）	obsession
妖冶而危险的女人	siren
预防措施	precaution	insurance
流浪汉	tramp	tramp
垂直位置	vertical
手脚能够到的范围	reach
器官	apparatus	organ
诞辰	birthday
[建]覆道	corridor
单纯的人：不世故的人	primitive
轻触	kiss
喧闹声	noise
英街道清洁工	orderly
预兆	sign	signal
油膏	grease
局面	situation
改革论者	progressive
大气层	atmosphere
前线	front
人称代名词	personal
]伊斯特尔绰号	Easter
对话	dialog
农家	farm
一期	number	installment
电视机	tube
[虫]腹部	abdomen
喜剧体裁	comedy
轻视	contempt	underestimate
羊栏	fold
和谐的一致	sympathy
法令	statute
后期	afternoon
空调设备	air-conditioning
捆绑	bind
拖曳的行为或情况	tow
十四点钟	fourteen
[法]移交	tradition
发源地	cradle
（某人的）命运	fortune
（隐修院）会长	prior
十年间	decade
证章	medal
蹦跳	hop	skip
基本	basic	fundamental
著名的人物	name
擦亮	polish
包围	embrace
诱饵	bait	lure
活动	event	movement	action	activity
面具	mask
一月	January
[乐]变调	transition
重音	stress	accent
潜力	potential
主餐	dinner
猎狗	hound
活力	bounce	dynamic	energy	pulse	sparkle	tuck	zip
蜡烛状物	candle
铁路公司	railroad
差距	remove
马戏团	circus	tan
以便征税）	appraisal
雨点般降落的东西	rain
四个一组之物	four
小山羊	kid
抵押单据	mortgage
[军]骑兵连	troop
残杀	massacre
头饰	tire
上端	head
增殖体	vegetation
老顽固	beast	fossil
牌子	brand
新闻报道	press
过多	overflow
雷达装置	radar
修剪	clip	trim
沉默	silence
有毒气体	damp
推翻	overthrow	overturn
松鼠毛皮	squirrel
走廊	corridor	hall	porch	gallery
纺织业	textile
过失	blame	debt	error	guilt	mistake	stumble	trip	wrong
热情	enthusiasm	fire	flame	passion	warmth	zeal
宴请	banquet
关税	custom	tariff
（名誉等的）污点	cloud
相等	equation
肌肉	muscle
亲爱的人	dear
征收	collection
家庭日用织品	linen
（土地的）一块	parcel
处女	maid	maiden	virgin
对白	dialog
剂量	dose
黑手党	mob
霉臭	must
寄物柜	locker
（维持、增加感情的）刺激物	fuel
（某些棋盘游戏的）筹码	counter
一大笔钱	bundle
专利品	monopoly	patent
反对	but	objection	protest	exception	exception
笔记	note
现代人	modern
助理	assistant
瞌睡	doze
班轮	liner
（工具等的）把	hand
花蜜	honey
女名家	princess
物理成分	physics
当代	today
小型私人会议	huddle
掌握	fist	grip
羊毛覆盖物	wool
鸢（猛禽）	kite
节奏逐渐快起来的集体欢呼	locomotive
协约国	ally
冒险事业	venture
布里	bury
出版	publication
风尚等的流行	epidemic
〈口〉讲道	preach
一群	bunch	crew	crowd	pack	parcel	sort	troop
准备排印的书面材料	copy
火箭发动机	rocket
恒星	sun
大公司	big
文化遗产	heritage
三脚架	spider
日本米酒	sake
主教（或大主教）权限	see
正式认可	permission
自己的事物	own
东道主	host
楔	wedge
封锁	investment
（运动）联合会、联赛	league
主张者	prophet
和解	composition	accommodation
[航]紧急起飞	scramble
楣	summer
楼梯	stair	staircase
回收再利用	reclaim
打架	fight
写作	writing
迸发	torrent
徒步旅行	hike	tramp
化验	test
美元	dollar
笔记本电脑	notebook
活用	improvement
铰链	hinge
[电]电压	tension
〈比喻〉（人生的）道路	path
抵押证明	mortgage
机会	chance	hazard	occasion	opportunity	turn
一种不稳定形式	stagger
[化]氮	nitrogen
客栈	pub	inn
毒害	virus
欠缺	defect
勒索	blackmail
专题讨论节目	forum
连续	chain	duration	sequence	series
小饭店	inn
前部	fore	forehead
艉	stern
[口]遮盖	lid
艏	bow	bow
水晶饰品	crystal
服务人员	attendant
笼子	cage
系主任	dean
恸哭	keen
放肆	liberty	excess
长时间	long
会诊医生	consultant
猜测	guess
过渡	transition
投扔	shy
求助	resort
储藏量	reserve
功率	power
投降	surrender
西南方	southwest
贪婪的人	wolf
港湾	fleet
像章	badge
（电视屏幕上的）重影	ghost
流音	liquid
[口语]必须做到的事情	do
圆筒	barrel	barrel	cylinder
博士头衔	doctorate
螺旋形物	spiral
防护装置	guard
寿命	life	lifetime
喙	tongue
进来的动作	income
爱人	love
门槛	threshold
嗥叫	howl
判决	judgement
附属团体	auxiliary
尊重	esteem	respect
讽刺文学	satire
（盗匪征收的）保护费	blackmail
化合成	synthesis
首都	capital
调查表	questionnaire
=“centimeter”（美）	centimetre
[天]银河系	universe
妇女	woman
船费	fare
[法]新法	novel
领悟	insight
财宝	valuable
理发师	barber
〈口〉（特殊的）人物	fish
谜语	riddle
备忘录	commonplace	memo	minute
（风	buffet
放任自流	drift
桩	pale	pile	post	stake
磨坊	mill
壮年时期	summer
最后部分	end
情操	sentiment
痛苦根源	complaint
观点	angle	concept	outlook	perspective	sentiment	viewpoint	standpoint
指印刷中所用的一种字体	modern
露水	dew
社会主义	socialism
海外	abroad
宗教	faith	religion
道义	principle
自保公司	captive
条例	statute
流出	stream	issue
煤屑	slack
极其滑稽可笑的人	scream
序曲	symphony
室	chamber
身体某部分的疼痛[不适]	pain
宫	palace
赔偿金	damage
前进	march	progress
教育活动	activity
家	family	home
压（迫）感	pressure
诗体	metric
盈益	take
法律顾问	counsel
来福枪	rifle
肯定的回答	yes
反光镜	mirror
友人	friend
伴随物	attendant
船体型线	sheer
纺织品	textile
哆嗦	shake
趋向	trend
橡皮	rubber
必要的事	imperative
前夕	eve
（沙	grain
（感情的）迸发	agony
时装	fashion
前夜	eve
概略	sum
[体育]诉请	appeal
箱	container
黑种人	Negro
雏鸟	juvenile
毛皮衣服	fur
隆起物	bump
政府	government	nation
（被告或被告律师的）抗辩	plea
附属物	tag
管	tube
母兽	cow
[航]帆装	clothing
脸红	blush
箭	arrow	shaft
尤指愤怒的）突然爆发	explosion
重担	weight
票价	fare
分支	branch	limb
〈英〉五朔节的庆祝活动	May
肋骨状的东西	rib
栽植	plantation
舞会	ball	dance
巨大	magnitude	size
探究	inquiry
隆隆声	boom	lumber	zoom
[化]皂	soap
原有事物	predecessor
均匀厚度的片状硬物体	plate
（语）音长	length
历史时期	era
舞伴	partner
（非法的）交易	traffic
脸色	color	expression
鼻梁	bridge
拉丁文	Latin
脂肪	fat
神迹	miracle
单独禁闭	solitary
[法律]轻罪	guilt
微型人像画	miniature
（丛书杂志等的）一部	installment
要害地	tower
批准	approval	permission	sanction
假冒	sham
闹饮	riot
搅动	stir
[总称]术语	technology
金雀花	broom
年长的	elder
冒充	fake
缓慢的爬行	crawl
肖像	portrait	resemblance
1620年移居美洲的英国清教徒	pilgrim
坑蒙拐骗的人	shark
[鸟]燕子	swallow
新兵	recruit
收成	harvest
瘸子	cripple
桥牌	bridge
自学的艺术家	primitive
毒品	drug
挫折	setback
旅行护照	chop
巧妙	skill
酬劳	recognition
通路	passage	road
文献	bibliography	literature
诉讼（事件）	case
步行的路径	walk
日常工作	routine
极有害的思想（或心情等）	poison
机车	engine	locomotive
大型敞篷摩托艇	launch
自由权	freedom
边疆	frontier
拼写	spelling
血	blood
一刻钟	quarter
纳尔	nail
牙科医生	dentist
灿烂的光辉	glitter
进行	proceeding	travel
棒球手套	glove
草屋	lodge
对立物	opposite
暖和的地方	warm
综合	synthesis
象鼻	trunk
含意	implication
浪漫派诗人[艺术家]	romantic
哀悼	regret
[体]裁判	official
交响曲	symphony
合成语	blend
佩蒂	petty
阉公牛	steer
（椅子等的）靠背	back
餐后甜食	dessert
听得见的范围	hearing
（某一语言的）词汇	vocabulary
条理	method
〈美俚〉脸	map
后果	resultant	train
冷淡	frost	ice
帆船	sail
混合色	blend
危险物	danger
诀窍	hang	trick
分支机构	affiliate
〈俚〉有文化的人	scholar
目的地	destination
无名之地	nowhere
谷物	cereal	grain
观察	eyesight	observation	remark
身份	condition	status
绝对事物	absolute
房东	landlord
地形	geography
杰作	effort	masterpiece
广大	magnitude
…。的奴隶	slave
[乐]音栓	trumpet
（美）内部通知	memo
宇宙	universe
美景	vision
符咒	spell
思想家	philosopher
安排	layout	disposition
疾驰	spin	tear
木匠	carpenter
展望	outlook
不安	tension	disease
（建筑物等的）骨架	skeleton
衰落期	winter
美方杂木丛生的沼地	cripple
街	row
文重要事件	page
阴部	private
（山脉	range
著作权	copyright
治安官	magistrate
滚筒	barrel
旅程	passage	voyage
若隐若现的景象	loom
羞愧	shame
（树枝等的）突然折断	snap
老鼠	mouse
玩物	toy
奔跑	run
鞭打	strap
不可缺少的人或物	indispensable
处女膜	cherry
急件	despatch
降落	drop	fall
好成绩	success
松树	pine
专使	express
感冒	cold
出汗（过多）的人	sweater
加仑（容量单位）	gallon
政体	government	regime
〈古〉无底深渊	chaos
进口	entrance	import	inlet
湿地	swamp	wet
旅客	guest	passenger
义卖	benefit
外部	exterior	external
用船渡运	ferry
口音	accent
形状	form	make	shape
香肠	sausage
转移	shift	transfer	diversion
行家	specialist	expert
关系亲密的伙伴	gossip
贵族	peer
词形变化表	paradigm
设计图	blueprint
令人费解的事[人]	puzzle
队列	array
伞形花序柄	ray
王位	royalty	throne
厩	stable
小鸟	isle
必要条件	requirement
活动期	season
素食者	vegetarian
结局	conclusion	ending	final
手套	glove
远亲	cousin
冒险	gamble	risk	venture
铁路系统	railroad
数字零	zero
指状物	finger
微不足道的人	peanut
（进行某活动连续的）一段时间	session
艰难情况	hardship
玩笑	joke
备办	preparation
<口>发烧	temperature
严寒	frost
保险器	safety
账目	account
属	breed
（课外）作业	assignment
动荡	storm
怜悯	mercy	pity	compassion
自愿者	voluntary
（纸牌的）梅花	club
局	bureau
层	layer	shelf
上等细麻布	lawn
巨人	giant
整齐	symmetry	trim
立体系统或立体像片	stereo
（鞋、袜等的后跟）	heel
山	mountain
识字	literacy
[数]结式	resultant
令人吃惊的事物	surprise
耐用性	wear
灭亡	destruction	overturn	ruin
（美国政府部门）局	bureau
长期离家[出国]	exile
最高点	peak
营救	rescue
社论（美）	editorial
[地]矿脉	vein
好听的声音	melody
下水道	drain
全部本领	repertoire
无所作为的生活	vegetation
民间音乐	folk
性特征	sex
[生物学]进化	progress
军人	military	soldier
村民	village
那儿	then
修订版	revise
密度	density
对决	encounter
罩袍	gown
计划者	layer
成绩报告单	report
类目	category
趣闻	anecdote
人种	race
调谐	tune
压印机	tool
帐篷	tent
撤出	vacation
流体	fluid
（陪审团的）裁决	verdict
嫩芽	shoot
[政]轴心	axis
同性恋者（尤指男性）	gay
信使	messenger
矮小的动物（植物）	dwarf
磁带	tape
请愿书	petition
办法	resource
足械	hamper
准则	criterion	formula	norm	principle
条件性陈述	whereas
香槟酒色	champagne
（鸟）窝	nest
〈美〉（南北向）街道	avenue
半径范围	radius
合乎条件的人（或东西）	eligible
[戏剧]（表演时的）姿势	attitude
强烈情感的冲动	flush
财产转换	conversion
（狮）群	pride
英（紧身的）短裤	pants
[乐]总谱	score
装束	trim
（学生的）作文	theme
[医学]带菌者	carrier
史诗	heroic
爱讲闲话的人	gossip
填空处	blank
悲叹声	moan
全景照片	panorama
知识范围	department
[俚语]解雇	boot
品质	character	chop	quality	sort
抵抗者	resistant
颜料	color	paint	painting
培养液	medium
（口）汽车	bus
底部	basement	bottom	floor	foot	underneath
结业证书	certificate
（法院的）判决	decision
[诗]节奏	rhythm
体格检查	medical	physical
[气象学]高气压	high
[航]襟翼	flap
[法]误审	error
消防队员	fireman
川	stream
好奇心	curiosity
被耽搁或推迟的时间	delay
平地	area	flat	plain	smooth
（土地、房屋、建筑等的）使用	occupation
自动记录器	register
公共场所	public
擦伤	bruise	graze
装配车间	assembly
淘气	mischief
一份	copy
马达	motor
工序	procedure	process
侏儒	dwarf
行李架	rack
非常时刻	emergency
早晨	morning
全人类	universe
大学人员	university
基谐波	fundamental
摄影机等的）瞄准	training
产地	habitat	locality
湿热	humidity
开发	develop
一种特别大且空荡的房屋	barn
（紧身裤袜或长筒袜的）滑丝	ladder
副本	counterpart	repetition
卫星区	satellite
销售额	sale
（法律、处罚等的）施行	administration
信纸	stationery
微型复制品	miniature
一列	procession
接替人员	relay
观察力	observation
治理的形式	government
蔬菜皮	peel
科技（总称）	technology
（作赌注用的）筹码	chip
[用复数]（音响设备中的）独立件	separate
短裤	short
开发者	pioneer
月刊	monthly
怒气等的）爆发	outbreak
粉状物质	powder
预备	preparation	provision
释放	liberty	release
店主	landlord	merchant	shopkeeper
部下	subordinate	inferior
跳水	plunge	dive	dive
展现	reveal
健康状态	trim
阵营（指观点相同且与持不同观点者对立的集团）	camp
太阳晒着的地方	sunshine
东方人	eastern	oriental
口容易受骗的人	mug
角镞箭	quarrel
染料	color	dye
两个	two
铁匠铺	forge
借用	borrow	loan
（尤指必须交费的）中学	college
平头	crop
十个一组	decade
社区	autonomy	community
（某些欧洲国家的）贵族	prince
缺少	shortage	absence
糜烂	erosion
呻吟般的声音	groan
地狱	hell
让步	concession
颜料溶解液	medium
矛盾	conflict	contradiction	discrepancy
煤玉	jet
〈古〉方式	kind
〈口〉临时凑合的代用品	apology
骗局	racket	trick
罗马教皇	pope
完结	shut
政治狂人（尤指政治上持激进或极端主义态度、行为异常、不可思议的人）	crazy
发展史	history
[乐]复唱	repetition
挤满	jam
[化]氧化物	oxide
说话能力或方式	speech
叙述	narrative	relation
税额	tax
命令	command	dictate	dictation	direction	order	word	imperative
（起伏地的）凹处	fold
所信赖的人或物	reliance
碎牛肉	hamburger	steak
[商]定期放款	fixture
哲学家	philosopher
桨状物	paddle
函数	function
硬路面	pavement
杂记文	essay
防水衣物	waterproof
反对改革的保守当权派	establishment
锯	saw
震颤感	thrill
重要地位	status	importance
小房子	cottage
机遇	chance	luck	accident
铁道	railroad
小糖果	kiss
年龄段	age
差数	remainder
粗暴的人	tough
奔流	flush	torrent
需要攀登的地方	climb
[天文学、占星术]狮子（星）座	lion
头发	hair
（政党等的）倾轧	collision
主要部份	staple
支架	bracket	cradle	leg	rack
瓷砖	tile
听证会	hearing
[法]扣押财物	distress
躯干	trunk
噩梦	nightmare
设计师	architect
暴风雨	storm	weather
圆屋顶	dome
弩箭	bolt
衬衣	shirt
潜能	potential
缰绳	rein
谣言	gossip	tale
犯罪行为	fact	guilt
夫妻	couple
某年级的学生	year
〈古〉时间	tense
入场费	gate	admission
[天主]教皇[主教]的仆人	familiar
女仆	maid
增加	augment	boost	raise	addition
无声	silence
白费	waste
衣服的胸襟	bosom
阻截队员	tackle
球状物	globe	round
强迫征兵	press
衬衫	shirt
（烧水用的）壶	kettle
（证人的）陈述	declaration
笑声	laugh	laughter
（房屋等的）固定装置	fixture
（火车站的）饮食柜台	buffet
欧鮊鱼	bleak
肉铺	butcher
经济学	economics
不义的行为	wrong
判断力	judgement
[橄]触球	try
工地宿舍	camp
喜剧演员	banana	comic
吊架	cradle
分离	divorce
（气候	hospitality
苦	bitter
（邮票的）面值	value
愤怒	anger	fume	rage	indignation
狭长的通路	aisle
风	wind
[金融]贷款	credit
大汉	giant
表情	brow	expression
罐头	can
电流	current	electricity
布置	composition
将临期	advent
入侵	invasion
分期付款	installment
垄断者	monopoly
（戏剧、小说等的）情节	plot
连续的一段时间	spread
（植物、水果等所含的）糖	sugar
麝香	must
恻隐之心	compassion
身体	body	person	system
〈口〉伙伴	lad
乱七八糟的一堆事物	jungle
爱嘲弄他人的人	tease
棕色皮肤的（亚洲）人（尤指印度人或巴基斯坦人）	brown
读本	reader
（表示友好的称呼）乖乖	duck
（诗的）韵律紊乱	limp
脑力劳动者	intellectual
得分	goal	point	score
娴熟	proficiency
导演	direction	director
基址图	plot
飞行员	pilot
东北部	northeast
眼泪	tear
[棒]练球场	cage
〈英〉号哭	keen
障碍物	block	obstruction
随从	attendant	suite
尚未交配的幼雄兽	bachelor
有害的幼虫	wolf
大声喊	call
家庭生活	home
抽象概念	abstract
战场	ground
根基	radical
植物	green	plant	vegetable
素净色	neutral
评估	gauge
自负的事物	boast
<美>传闻	rumor
求婚	offer	proposal
机关	apparatus
[史]伊比利亚半岛	peninsula
作品(opus的名词复数)	opera
建筑（艺术或行业）	building
磨蚀	erosion
紫红色	wine
混淆	confusion
口角	quarrel
引用	quote	excerpt
肉（或鱼等）酱（作涂抹料或烹饪用）	paste
基金（会）	foundation	foundation
（壳、草等的）叶片	blade
执照	license	permit
传记体文学	biography
酒精	alcohol
流逝	glide	lapse
[数]（对数的）首数	characteristic
圆规	compass
工作组	team
画笔	brush
解释	apology	construction	definition	explanation
（人的行为或衣着的）特征	trademark
小声抱怨	mutter
不远的将来	tomorrow
箭头记号	arrow
（美国警察局的）副巡长	captain
大厅	hall	lobby
原谅	pardon
平静	calm	still
懦夫	chicken	coward	worm
[事]出击目标	objective
盈余	margin	surplus	abundance
宗谱	tree
常去	resort	resort
令人高兴的事（或人）	joy
独白	aside
旱灾	drought
隘路	narrow
计数	count
泡沫材料	foam
大厦	block
流放犯	transport
大使馆	embassy
稻	rice
烘烤食品	bake
紧要	moment
〈美俚〉勒索金钱	racket
十字形饰物	cross
平面	plane	smooth
播种	broadcast
口	mouth
[棒]曲线板	curve
遗赠的条款	devise
大事	event
特约稿	special
直率	freedom
华丽的娱乐场所	palace
体重等级	category
局限	limitation
台	platform	stand
号	issue
缺席	absence
[军]战区	theater
合意	consensus
某种类型的人	specimen
汉堡包	hamburger
牵连	implication
出身低微者	simple
大亨	big
复习	review
验定	analysis
代号	code
慢慢露出	peep
绳索	cable	rope
扇形物	fan
〈古〉计算	tale
强壮的人	athlete
距离	remove	distance
喊价	bid
[无线]线圈架	former
账单	bill
班	class
海边	seaside
投票厅	lobby
（古代神话中的）神人	hero
电话分机	extension
回纹针	clip
咨询者	consultant
疑心	suspicion
偿还	payment
平均水平	average
腊肉	bacon
版本	edition	text	version
格言	moral	saw
不变的事物	constant
辎重	baggage
日光浴室	solar
严峻的考验或磨难	furnace
弯管	elbow
宫殿	palace
特刊	special
报酬	consideration	money	payment	reward
违背	breach
同伴	companion	fellow	partner	partner
痕迹	mark	scent	touch	trace	trace	track
（枪炮、火箭等的）射程	carry
缄默	silence
电话接线员	operator
自己人	own
口家伙	customer
重击声	pound
深奥	depth
整体	whole	integral
（表示不确切的描述或数量）大致	something
破旧衣服	rag
定义	definition
玻璃灯罩	chimney
流注	stream
（电话）号码簿	directory
双胞胎之一	twin
（灵魂）深处	profound
（军舰等的）游击	raid
壶等的）口	lip
制剂	preparation
宠物	dear	pet
泄漏	escape	leak
称心如意的人[东西]	desirable
鲸鱼	whale
猛拉	tug
（文学家等的）爱读者	public
审美观	aesthetic
测量流水等的单位	module
文房四宝	stationery
受他人操纵的人	puppet
昏乱的状态	tangle
（表示否定）微少	little
贮存	storage	store
麻将牌	tile
书志	bibliography
玩忽	neglect
本人	self
闪光	flare	flash	glance	twinkle
弹跳	bounce
老婆	wife
（英国议会的）议员席	bench
颜色	dye
甲板	board	deck
日常工作事项	agenda
屠夫	butcher
早餐	breakfast
浪漫关系	relationship
上诉状	petition
（机构	headquarters
民族性	nationality
余火	spark
叔叔	uncle
脚底	sole
研究室	lab
（尤用于形容词后）家伙	dog
喊叫	call
吝啬鬼穷光蛋	stiff
受雇	employ
滋味	relish	taste
小片	scrap
〈英〉繁荣的手段	thrift
地球	earth	globe	world
通常有大教堂的）特许市	city
板球	cricket
…大王	king
叶卷烟	cigar
水平的物体	horizontal
合同书	agreement
螺帽	nut
收获	pick
磁带录像	video
分开的事物	separate
陶盆	pot
勒马绳	curb
夸奖	applause	puff
漫步	stroll
[乐]基础低音	generator
[生]生存竞争	competition
晚餐	dinner	supper
垮	breakdown
顶梁柱	pillar
一体	one
幼兽	get
气体	gas
六岁	six
富有诗意的东西	poem
（医生或律师的）业务	practice
卵石	pebble
日志	diary	journal
预定继承人的顺序	entail
（国家、政党等的）结盟	alliance
慢车	local
[统]全域	universe
无党派人士	independent
设计	design	device	layout
房屋等的）排列	range
前辈	better	predecessor
运动项目	event
野蛮人	savage
铁路	railroad
英史保王党员	malignant
宗主国的公民	metropolitan
速率	velocity
阵地	ground
化酸	acid
项链	necklace
链球	hammer
殷勤	attention	hospitality	address
范例	paradigm	specimen	example
遗孀	widow
专科医生	specialist
[考古学]（古代村落遗址堆积而成的）台形土墩	tell
宏伟大厦	palace
在复活节出生或受洗礼者	Easter
（俱乐部、协会等的）分会	chapter
议院等的）边座	gallery
公差	tolerance
可用来记重量或作为货币单位	talent
晶体管	transistor
[物]布居	population
（二人座）S形椅子	sociable
[建筑学]屋脊	hip
冲击	storm
礼仪	ceremony
[逻]结论	consequence
配制品	preparation
妨碍	interference
（同班）同学	classmate
补充	complement	supplement
高脚凳	stool
见闻	knowledge
物马力	horsepower
尊贵的人	noble
滨	shore
民主国家	democracy
胃液	juice
[复数]drys[非正式用语]主张禁酒的人	dry
精彩的表演	spectacular
〈口〉非常丑恶	horror
发祥地	cradle	nurse
照片	photo	picture
（因财富和社会地位而仅有部分人享有的）权益	privilege
半岛	peninsula
晶体	crystal
开销	spend
〈俚〉情人	lad
意思	meaning	significance
寄生物	parasite
（英国）下议院	house
摔倒	fall	trip	tumble
基础	base	basic	basis	foundation	foundation	fundamental	ground
骗子	artist	cheat	fake	fraud	hawk	sham	sharp
[生态学]生产率	productivity
公转	revolution
（肌肤的）痛处	sore
旁边	side
窗	window
<正式>过去	yesterday
军舰	warship
女修道院院长	mother
大批赃物	haul
有运动员品质[道德]的人	sportsman
显示	show
全世界	universe
稻草	straw
[游戏]复局	duplicate
丰碑	monument
献身…的人	servant
尾随者	tail
（指成年女子	lady
（家庭或团体中）最年幼的成员	baby
王族成员	royalty
冰淇淋	ice-cream
咒骂	swear
氧气	oxygen
生手	amateur	infant
证据	evidence	fact	testimony	tribute	witness
（派驻联合国等国际组织的）代表	ambassador
奇遇	adventure
七个	seven
桔子	orange
方法	fashion	highway	how	kind	line	manner	medium	method	regime	road	sort	system	way	approach
论题	thesis	topic
[法]继承的产业	fee
圣经中的节	verse
圆周	circumference
毯子	blanket
符合	correspondence
对策	put
[商]佣金	commission
橡木色	oak
持续的时间	duration
隐蔽处	shadow
运动衫	sweater
[牌]摊牌	declaration
罪行	crime
张贴者	poster
无聊的人或事	yawn
绕道	roundabout
市政债券	municipal
蒸锅	steamer
橹	oar
温度表	mercury
亏损	deficit	loss
超级市场	supermarket
两星期	fortnight
止血敷布	compress
修订	revise
魔鬼	devil
生长	growth
艺术家	artist
监护人	committee
无	nothing	absence
具有讽刺意味的事	irony
文件	paper
牧群	herd
窘境	bind	dilemma
草	grass	herb
触感	touch
（诗歌	burden
研讨班	seminar
结合	join	wedding
舒适	comfort	ease
引航员	pilot
庭院	courtyard
增刊	supplement
最好的东西	best
小伙子	lad	youth	boy	chap
偷偷接近	stalk
目的	destination	goal	mind	purpose	sake	target	intention
（动物的）爪	claw
（运行）环境	environment
咳	cough
（未获学士学位的）大学生	undergraduate
杀害	destruction
类似物	representative	similar
嘈闹的宴会	riot
剪票铗	punch
咬	bite
词的拼法	graph
天父	father
[医]病灶	focus
通知	circular	information
忠告	advice
“鉴于…”：正式文件的介绍性陈述	whereas
地位	position	role	station	status
矿石	mineral	ore	stone
不透明	opaque
陪审团	jury
冒牌货	fake	fraud
牧草	herb	keep
装载	load
完全	full
[化]氧	oxygen
丝绒	velvet
音轨	track
麻烦事	knot	nuisance
联结	bond
电视连续剧	serial
保持力	retention
诱惑物	bribe	lure	temptation
难题	knot	puzzle
手柄	handle
猛烈抨击	slaughter
愚蠢的行为	nonsense	simple
垮台	collapse	overturn
主体	bulk
伏特数	voltage
文学作品	literature
蓄电池	battery
赔偿	compensation
十二	twelve
口头禅	commonplace
（剧情的）发展	discovery
字典	dictionary
果心	core
步态	walk
口搭车（者）	pickup
教练	coach
节目	programme
北方	north
（计算机与其他设备的）接口	port
[统]权	weight
喷嚏声	sneeze
尾巴的骨肉部份	dock
储备物质	supply
团结	solidarity	union
餐叉	fork
文官	civilian
所发的球	serve
鬼把戏或诡计	shine
狠毒的女人	cat
经验	experience
[板]得五分	five
令人不愉快的事物	nasty
捐助	charity	contribution
石油	oil	petroleum
协议	compact	treaty	agreement
突出的部分	nose
从业者	practitioner
（动物的）脊肉	saddle
唠叨	jaw
（乘坐汽车等的）旅行	ride
救济措施	salvation
偏离的方向	sheer
大惊小怪	fuss
百分比	percent	percentage
钟（表）面	dial
烟尘	smog
庞然大物	monster
牛属动物	ox
一般性	universal
齿轮	gear
（织物、毛皮等的）手感	handle
datum的复数	data
清理	disposal
笔尖	pen
毛病	defect
广大的世界	wide
过程	journey	procedure	process
搏动	impulse
训令	prescription
渐衰期	autumn
收音机	radio
撇去的东西	skim
表面	face	surface	exterior
鼓舞人心的人或事	inspiration
被捕杀的动物	kill
雇员	employee
〈口〉（使用）信用卡	plastic
蓝色	blue
时钟	clock
课时	hour
独立心	independence
领导人	van
战略（战术）计划	disposition
翻转	turn
高原（地区）	highland
推动力	locomotive	urge
全盛期	noon
造成困苦与苦难的原因	hardship
充分	enough	fill	full	plenty
停滞	rust
事情	affair
能行动的动物	locomotive
葡萄酒	wine
辣椒	pepper
数据库	database
一年的期间	year
小叶	leaflet
离题话	aside
穿旧	wear
宗教服装	habit
加餐	snack
池塘	basin	mere	pond
奥秘	secret
牺牲者	victim
[医]嗫音	whisper
肉体	clay	flesh
纳贡	render
军部署	disposition
父亲（或母亲）	parent
扩大的人	amplifier
[数]同类项	bracket
报答	pay	payment	reward
骑马的军人	horse
家庭教师	tutor
外罩	housing
发球权	serve
打出的牌	discard	discard
枝条	stick
（物体的）圆形或凸起部份	belly
德行	virtue
小精灵	fairy
会计师	accountant
气候	climate
（楼房的）一层	flat
劫掠	raid
巧克力	candy	chocolate
知识分子	intellectual
闲逛	stroll	wander
警惕	precaution
视野	sight
平凡	prose
耳堂	aisle
求助[凭借]的对象	resort
磨损	erosion	wear
舌头	tongue
动产	goods
电子	electron
难以控制的人（或动物）	handful
工作	assignment	effort	employ	labor	occupation	pursuit	task	thrift	work
（板球）一百分	century
税务署	revenue
地窖	cellar
野战军	army
处所	dwelling
豌豆状物	pea
脾气乖戾的人	crab
带柄三脚平底锅	spider
哭	cry
白热	glow
金钱	pocket	dollar
书桌	desk
灯罩	lantern
火腿	ham
[宗]回应经文	response
枢要	hinge
差额	difference
电阻	resistance
（旅馆等的）单人房间	single
汗毛	down
特制品	speciality
环状物	wreath
课堂	classroom
意想不到（或突然）的事	surprise
悲剧表演艺术	tragedy
欢送	farewell
拉杆	rod
受抚养人	dependent
时髦的人	fashionable
提供消息的人	source
底稿	manuscript
景象	prospect	sight	spectacle
合理的事物	rational
分散注意力	diversion
地域	region	scope
溶解	solution
一阵（疾风等）	blast
推理剧	mystery
感情等的）奔放	riot
零售商	merchant
困惑	confusion
国内	inland
研究结果	finding
幼小的动物	young
〈美〉（政党等的）领袖	manager
长筒袜	hose
抢	snatch
早期的艺术家（作品）	primitive
学问	learning	wisdom
（给演员）的提白	prompt
报	newspaper
编队	formation
思潮	climate
受珍视的人[物]	jewel
征求意见者	consultant
[数]变换式	transform
凝视	gaze	regard	stare
边境	frontier
年龄	age
鞍状物	saddle
动画片	cartoon
升半音	sharp
经历	event	history	experience
杆	pole	post	rod
抓	catch
顶	top
长柄木铲	peel
投	cast
学术	learning	scholarship
大剪刀	shear
保管	maintenance
救世主	christ	salvation
[计]域名	domain
采访	interview
一致同意	consensus
原子能	atom
摄影机	camera
小巷	lane
珠状物	pearl
云状物	cloud
圈套	hook	trap	web
（混合物的）组成部分	ingredient
步行	walk
解救办法	salvation
[数][物]频率	frequency
寂静	quiet	silence	still
联姻	alliance
突然查抄[搜捕]	raid
[常用复数]赢得物	win
学期	session	term
瓦解	overturn
喝酒狂闹	riot
海底生物	submarine
情形	status
狩猎	shoot
箭状物	arrow
猫头鹰	owl
日出（时分）	sunrise
[多用于英国]律师的办公室	chamber
畜栏	stall
松木	pine
到达者	arrival
说唱歌	rap
[艺]手法	mechanism
沟	trench
巧克力色	chocolate
内庭	chamber
圣人般的人（指特别善良、仁爱或有耐性的人）	saint
出港证	chop
事件	event	matter	occurrence	phenomenon	scene	thing	affair	incident
英行李	luggage
使人高兴的东西或人	delight
读法	pronunciation
医院	hospital
同等	equality
专有财产	peculiar
无力偿还债务者	bankrupt
五个	five
油	oil
褥草	litter
当事人	client	party	principal
鱼鳞	scale
水池	pool	sink
袋	bag
战役	battle	campaign
朴素	simplicity
页	leaf	page
水汽	vapour
政纲	politics
拼贴和构成派雕塑等拼凑而成的艺术品）	combine
儿童时代	childhood
微笑	smile
畜牧场	farm
告别	farewell
其他人员	remainder
永恒	forever
官吏	servant
土著人	native
生产力	productivity
冰糖	candy
前锋	forward
打盹	nap	nod
奥古斯特	August
办事员	clerk
严寒时期	freeze
损害	damage	harm	mischief	nuisance	injury	insult
无音讯	silence
[法]显示证据	discovery
第三档	third
香料	flavor	perfume
职责	duty	job	province	responsibility
卵	egg
卷	book	volume
许多	deal	hundred	lot	lump	multitude	sea	ton	twenty
（皮）疹	rash
外地人	stranger
透孔织品	lace
诙谐	humor
亲切友好的的人	darling
整个的藏书架排列	stack
[常用复数]在两末端的事物	extreme
婚礼	wedding
橡木家具	oak
花园	garden
[板]歪球	wide
半	half
午餐	lunch
失败之作	turkey
卖	sale
统治者	governor	ruler
有灵异能力的人	sensitive
索具	tackle
讽刺	dig	lash	salt	satire	irony
内地	inland	interior
（杯	lip
轮船	boat	steam	steamer
共同体	community
肋骨	rib
（精神上或肉体上的）折磨	torture
[电讯]天线	aerial
企业	establishment	firm
打包	packages
远行	voyage
不动的人	stationary
歌剧艺术	opera
后部	back	rear	afternoon
葡萄汁	must
胶片	film
高级中学	gymnasium
物	news
门闩	bolt
情感	emotion	affect
恐怖行为	terror
名词性单词	noun
设想	concept	fancy
轮子	wheel
牛	ox
牙	tooth
片	piece
好结果	success
风土	climate
讨厌鬼	pill
不尊重	disregard
鞠躬	bow	bow
有价证券	security
蓄电（瓶）	storage
爱打听的癖性	curiosity
同侪	peer
伟人	worthy
勇士	brave	hero	lion
吻	kiss
光点	radiant
文艺复兴时期（欧洲14、15和16世纪时	renaissance
芭蕾舞团	ballet
天体	globe	sphere
男主角	hero
运送	carry
听	listen
沉淀物	deposit
[计算机]主机	host
吨	ton
贴现	discount
（鞋	toe
[冶]渣壳	skull
装运	shipment
天使	angel
[电影]惊爆星期四	Thursday
治安推事	magistrate
桌布	cloth
哲学	philosophy
避难所	harbor	refuge	shelter
背叛者	traitor
美邻居	neighbor
排挡	speed
讨论	conference	counsel	debate
可怕的人	terrible
婴儿室	nursery
考证	criticism
意义	meaning	significance	value	import	intention
高速	velocity
龙头	cock
突发	burst
抱负	ambition
加固材料	reinforce
嗡嗡声	hum	zoom
带状地带（或森林、湖面等）	strip
耳垢	wax
折中物	compromise
弄翻	turnover
奋发	zeal
骨朵	bud
坏心境	mood
合唱队	chorus
一段时间	cycle	span	spell
〔古语〕仪态	gesture
底座	mount
家庭主妇	housewife
快速的旋运动	spin
特邀嘉宾	guest
相配的人（或物）	match
法衣	robe
价钱	cost	price
米	metre
鞣料	tan
相识	acquaintance
有指导意义的事物	guide
帝权	empire
妓女	tramp
信息	message	information
低水平	low
赢利	get	return
剩余额	surplus
幸运	fortune	mercy
古代的一种计量单位	talent
柠檬	lemon
墓碑	tomb
复数形式	plural
毛驴	donkey
谚语	saw
抵抗	resistance	stand
分给	assignment
[航]教练机	teacher
凉气	cool
乌合之众	mob
树林	wood
美口（防止泄密的）堵漏人员	plumber
偏远地区	wild
（警察为抓捕罪犯而设的）圈套	sting
外科医生	surgeon
树枝	branch
抵押	borrow	mortgage
负责人	director	principal
探查	probe
群体生态学	sociology
（不寄宿的）仆人	daily
[物]静电（干扰）	static
秩序	economy	order
美纸烟	cigaret
天地万物	universe
毒素	virus
口亲爱的	honey
移植物	transplant
领域	area	kingdom	realm	region	sector	territory	world	domain
樱桃	cherry
登陆护照	chop
过路人	passenger	passer-by
临近街坊	neighborhood
主题	argument	staple	subject	text	topic
主意	idea
（眼睛的）闪亮	twinkle
腐蚀	erosion
资本（或财富）的拥有	capitalism
被告席	dock
体罚	rod
提纲	outline
天线	antenna
地下通道	subway
〈英〉火车客车车厢	carriage
玩具	toy
（群居性昆虫）兵虫	soldier
（进行中的）行动	purpose
传说	fable	fame	legend	story	tale
紫铜色	copper
驾驭（法）	rein
讨厌	dislike
齿状部份	tooth
大学预科	gymnasium
（常用于室外的）金属烤架	barbecue
螺旋桨	screw
胭脂等化妆品	paint
经理	manager
口充沛的精力	vinegar
平民	citizen	civilian	common
欺骗（行为）	cheat
遗传因子	gene
平装书	paperback
热烈拥抱	hug
木炭	coal
驼背	stoop
直径	diameter
乡下房子	cottage
插入物	inlet	insert
害怕	fear
单人表演	solo
〈俚〉贿赂	grease
兽群	flock	herd
一大片（覆盖物）	sheet
学术团体	academy
追求	quest
中枢	centre	hinge	nerve
汽笛	siren	whistle
胜任	grip
劫持	hijack
深海	depth
爵士舞（曲）	jazz
所在地	seat
东南	southeast
避孕措施	precaution
落花（叶等）	shatter
膨胀物	expansion
衰退	ebb
女人本能	woman
[乐]和弦基音	root
神怪故事	myth
掣子	click
（男人的）女朋友	girl
啭鸣声：尖厉高音	whistle
原称苹果电脑公司	apple
实体	entity	reality	existence
[法律]（获得或更新租契时交纳的）地租	fine
字母表	alphabet
比	proportion	ratio
折痕	fold
大衣	overcoat	wrap
地势	geography
口妨碍	liability
宽大扁平的部分	broad
动词	verb
黄铜饰品（尤指马挽具上的黄铜圆片）	brass
中立国	neutral
人名地址录	directory
沙	sand
试衣	fitting
鸡冠状的东西	comb
〈集合词〉家禽	poultry
重要人物	great
美俚容易得到的称心东西	pie
宝座	throne
婚约	contract	engagement
命运的三女神	destiny
起联系作用的东西	bridge
电影业	cinema	movie
舒服	satisfaction
鄙视	scorn
娱乐场	resort
帝王	monarch
一点儿	ounce
正中	middle
小塞子	spill
追究	research	inquiry
时刻表	schedule
秋天	autumn
喷射器	gun
牢骚	beef
露面	appearance
空虚	vacuum	vanity
晒黑的皮色	tan
娱乐（方式）	recreation
远航	expedition
寂寞的心情	void
方块	diamond
屡屡引起争论（或分歧）的问题	football
赤字	deficit
硝化甘油炸药	soup
旅游	trip
大声叫	yell
配套元件	kit
传闻	fame	mouth	report	tell	whisper
南方人	southern
壮丽	glory
遗骸	dust
家族	family	kin	strain
拍手声	clap
扬声器	loudspeaker	speaker
遗赠	devise	legacy
[宗教][常用P-]特定节日等用的仪式	proper
钟摆	pendulum
（楼梯的）一级	stair
受话器	telephone
（书页等的）上栏	top
水坝	dam
户	door	household
水坑	basin
回报	carrot
戳	poke
提问	quiz
（火车的）餐车	buffet
考古发掘	dig
水手间的亲密称呼〕	mate
香精	essence
（出版物的）版式	format
大步	stride
电池	cell
诗节	verse
侵袭	invasion
鱼肉	fish
巨物	giant
护膜	overcoat
马鞍	saddle
猛冲	dash
小道	track
零售	retail
围篱	pale
那时	then
（部队的）检阅	parade
国际组织	international
快餐	snack
供养	keep
教学方法	classroom
（旧时载客的）四轮马车	carriage
最好者	primary
评论文章	criticism
俭省	spare
旋律	melody
[语]集合名词	collective
界	kingdom	realm	region
控制（权）	rein
灰尘	dust
鲜明特征	signature
猜想	perhaps
排演	rehearsal
[数]除法	division
可听到的声音	audio
鸽子	pigeon
产品样本	catalog
注册	register
饲料	keep
稻米	rice
罗马法典	digest
[生]幼芽	germ
时候	when
发言权	say	say	voice
参加狩猎旅行的人	hunt
上诉	appeal
草莓色	strawberry
礼拜	worship
发现者	detector
[机]装配	assembly
长队	queue
胡说	nonsense
减少量	decrease
按钮	button
导师	tutor
不受欢迎的人	dog
[计]（鼠标）点击	click
养成所	nurse
读物	read	reading
村庄	ham	village
发光体	light
材料	data	material	stuff	substance
（分享到的或贡献出的）一份	share
签名册	album
无风	calm
（系船的）缆绳	painter
[航]翼肋腹部	loom
田	field
赝品	fake	sham
奇特粗俗的语言[方言]	jargon
男	male
欢呼	applause	cheer
（某企业的）经营者	operator
明细表	schedule
贵重物品	valuable
自由	freedom	liberty
得益	profit
乡下的全体居民	countryside
声音渐强	swell
夸脱（液体或固体的容积单位）	quart
下有多个分社的旅行社	multiple
部件	member	section
约定	engagement
一块[茶匙等]糖	sugar
往昔	yesterday
[艺]通感	correspondence
银河系	galaxy
模式	model	pattern
五十个人	fifty
[女子名]琼	June
苦难	rough
导管（套管的一种）	conductor
唤回	recall
曲线	curve
（尤指）企图杀害	attempt
社群	society
复位	replacement
忽视	overlook	slight	disregard
[体]（网球等的）扣杀	overhead
[医]发病	invasion
起限制作用的规则（或事实、条件）	limitation
约等于3英里）	league
航行距离	sail
起保护（或缓冲）作用的事物	cushion
大便	stool
（开掘等时挖出的）弃土	spoil
[植]盔状花冠	helmet
芭蕉属植物	banana
繁重、耗力的劳动	sweat
旧时在英国使用的金币	noble
聪颖	intelligence
物质世界	outward
立方体	cube	solid
苦味物	bitter
对立方	contrary
残酷的人	butcher
马克思主义者	Marxist
伟业	feat
交易	bargain	business	buy	market	transaction	exchange
引体向上动作	chin
物主	owner
（系船用的）缆绳	cable
英〉硬海滩	hard
谷类植物	cereal
保证	guarantee	pledge	security	assurance
狐	fox
（通常反对变革的）当权派	establishment
速记法	shorthand
神召	vocation
非正已婚的年轻人	married
邮递员	mail	postman
公务员	officer	official	servant
西装	suit
恶人	monster
起源	birth	germ	origin	parent	seed
食堂	canteen	mess
替换品	spare
隐约的一点点	ghost
默认	allowance
叶状的结构	leaf
大学教师	academic
人力[数]	strength
默许	allowance
静思	retreat
属性	attribute	property
对…有了解	acquaintance
警察局长	prefect
债券	bond
牛奶	milk
溅上的斑点	splash
视觉	eyesight	vision
电台、电视节目	broadcast
说某种语言的	phone
视角	viewpoint
越过	pass
指挥	command	direction
准许	consent	permit
（政府等的）机关	machinery
暗礁	shelf
[复数]（颜色、织料、式样等配合协调的）女套服	coordinate
炫耀	glare	display
战壕	trench
其次	then
敌意	hatred
显示屏	monitor
体格	build	constitution
暗示	cue	hint	suggestion
（商品定价、贷款利息等以外的）加价	premium
（人或物的）特征	attribute
电话联络	call
支配权	control
美候选人名单	ticket
[法律]（对土地、水域的）共有权	common
狐狸	fox
计划大纲	blueprint
伯父	uncle
（药的）一服	dose
彩车	float
进展	stride
[美国口语]棒球	apple
[语法]主动语态	active
仇恨	hatred
梳子	comb
醒悟	dawn
入门	alphabet
欧洲大陆	continent
沙滩	sand
冲突	clash	collision	conflict	encounter	friction	strife	warfare	interference	interference
交通工具	vehicle
岸	shore
愚人	fool
自治国	autonomy
拍子	tempo
元气、志气	spirit
人质	hostage
匆忙赶路的人	poster
平均数	mean
[复数][合同、契约用语]上述各点	premise
优先	priority
[物]合量	resultant
工业技术	technology
代（约30年）	generation
眩惑	dazzle
斋戒期	fast
[哲]理念	idea
诗意	poetry
〈口〉超音速飞机	supersonic
滞留	retention
谋反	treason
交际	conversation	traffic	intercourse
名望	fame	reputation
被废弃的事物	obsolete
南部	south
〈美〉（各州众议员）选举区	district
法规	legislation	prescription	statute
不动产权	estate
面上的）参差不齐	jog
征服	conquest
〈非〉嘲笑	shaft
论坛	forum
晶体锆灰色	jargon
怪物	monster
了解	knowledge	understanding
悲剧式作品	tragedy
股市看涨的人	bull
虚构的文学作品	fiction
俚破车	heap
王冠	crown
打手	bully
岩脉	vein
姑妈	aunt
袭扰	harassment
爱抚	caress
thegiggles止不住的格格笑	giggle
铅笔	pencil
（击高尔夫球的）楔形铁头球棒	wedge
功勋	merit
租契	lease
继任者	representative	successor
鞭伤	whip
醋	vinegar
电输入端	input
推销员	salesman
兴奋感	thrill
正派人	christian
打扫	clean	sweep
明暗	tone
洒出（量）	spill
跟球打法（使竿击的球在击中目的球后继续滚动的打法）	follow
硬外皮	crust
水泥	cement
顾客	client	customer	patron
丝毫	damn
水泡	bubble
硬壁回力球	racket
化肥	fertilizer
保龄球运动	bowling
赃物	theft
橙子	orange
货运列车	freight
加重值	weight
基本要素	essential
滑坡	coast
采用	introduction
（法院、法官的）判决	award
白话	bat
楼上	upstairs
信赖	reliance
肉排	steak
[无线电]（电磁波等）脉动	pulse
废料桶（装工地废料	skip
皱纹	wrinkle
排列方向	orientation
古柯碱	cocaine
停滞期	plateau
慈悲	grace
声音回路	audio
歌	lay
可供选择的事物	alternative
充溢	overflow
梗概	analysis	outline	skeleton	sketch
流线型	streamline
罢工[课	strike
晚年	evening
红利	bonus	profit	dividend
被踢来踢去的难题	football
试件	coupon
风景	scene	scenery	view
胃口	appetite	belly
舆论的裁决	jury
直径长	diameter
[复数]（高尔夫球一对一的）二人对抗赛	single
主动精神	initiative
耐久品	durable
画廊	gallery
虚礼	ceremony
亲爱的教友	beloved
注意事项	hint
正	true
演员表	cast
内部	bowel	within	inner	interior	inward
地毯状覆盖物	carpet
上层集团	elite
授给物（如财产、授地、专有权、补助、拨款等）	grant
黑话	jargon
沿革	story
静力学	static
乡下	country
味道	relish
皇家陆战队兵士	jolly
跳动锤	tilt
衣服	array	clothes	clothing	costume	dress	garment	stitch
恣意	fling
连贯	flow
形似	resemblance
辩护人	counsel
一步	pace	tempo
先知	prophet
胡椒粉	pepper
决定因素	parameter
美人	beauty	fair	lovely
信任	belief	confidence	faith	reliance	trust
熟练者	expert
万有	universe
斯坦恩	stern
（保险公司的）保险	cover
[物]光线锥	pencil
贮存器	storage
质疑	challenge
信仰	persuasion	profession
纪念物	memorial
信件	correspondence
（尤指比赛或游戏中）投掷	toss
胸部	bosom	breast	chest	heart
社会事业机构	institution
光泽剂	polish
通风口	outlet
步枪	rifle
补充兵员	replacement
输出	output	export
统治集团	hierarchy
养老院	hospital
涌现的人（或事物）	wave
临死的挣扎	agony
核心	core	machine	nucleus	quick
（意见等的）一致	consent
照顾	care	consideration
〔建〕钢筋混凝土	concrete
水雷	mine
皇帝	emperor
模糊的感觉	glimpse
鼻子	nose
糖	sugar
[会]小额	petty
潮汐	tide
彩票	lottery
美软烤饼	biscuit
[建]遮檐	opaque
追寻者	pilgrim
（高尔夫球场的）深草区	rough
污水坑	sink
暂时	season
发出臭气的人[东西]	smell
宣称	profession
招贴	poster
五色缤纷	riot
系	department	faculty
回复	feedback
〈罕〉近亲	vicinity
阿斯（古罗马重量单位	as
特效药	specific
弹药库	magazine
保护层	overcoat
一大罐（壶）的容量	jug
发射台	pad
强调	emphasis	stress	accent
毛骨悚然	creep
队伍	procession
万有引力	gravity
眼睫毛	lash
[宗]（弥撒的）序诵	preface
倒闭	failure
烤肉	barbecue	roast
慈善（行为）	charity
指引	leadership
[建]基底	basement
指望	promise
不屑一顾	scorn
〈俚〉可可粉	thick
好的珍珠	orient
游说团	lobby
讨厌的人（或事物）	beast
金属块（锭）	pig
日晷	dial
退兵信号	retire
外胎	shoe
流域	basin	valley
运输量	traffic
（可当作新闻内容的）人	news
客套话	formula
剪切	shear
操练	drill
些微	fraction	hair
口压力	squeeze
森林	forest
（容量单位）升	litre
（胸罩的）罩杯	cup
（四足动物的）后脚	heel
有意义的事物	significant
[电]故障	fault
沉思	meditation
纪念碑	memorial	monument
大米	rice
样子	look	manner
打趣话	wit
护士	nurse	sister
规律	law	rhythm
拱形物	arch
冠军	champion
被盗	theft
伤心	anguish
主要演员	principal
重复	repeat	repetition
困扰	disturbance
〈俚〉避孕套	safe
意志（力）	will
滑雪板	ski
侵蚀	erosion
（啤酒）杯	jar
荡妇	baggage
[计]（软件的）套件	suite
尽头	bottom
大行政区	province
产量	crop	output	produce	production	yield
行为）麻烦事	nuisance
嬉闹	fun
疔	boil
分类人事广告版	personal
避难	refuge
离合器	clutch
（职位的）空缺	opening
〈口〉屁股	behind
大约的程度或者数量	vicinity
驿站	stage
科学	science
（速度等的）平均率	average
（词之间性、数、人称方面与…）一致	agreement
[theother]对立面	other
环形广场	circus
酸味	sour
检查	survey
（正式）讨论会	conference
发行物	issue
幼苗	offspring	shoot
惯例	convention	custom	manner	practice	tradition	usage	institution
一番	dose
平安	safety
借款	loan	advance
飒飒声	whisper
熊猫	panda
山冈	hill
打洞器	punch
开场白	whereas
[物]基频	fundamental
呼吸器官	lung
苔藓	moss
判例	case
活页文选	pamphlet
阔人	wealthy
纺]落纤	tow
银制品	silver
[植]雄性植物	male
燃料	fuel
惊奇	surprise	wonder
需求	demand	market
容易的工作	pie
（美国）东南部	southeast
潜艇	submarine
暴乱	riot
单程票	single
反败为胜	rally
脉搏	pulse
军服	uniform
入口处	entry
自动机	robot
种类	breed	category	class	description	feather	species	stripe	variety
皮靴	boot
物质的化学组成（或性质）	chemistry
颤音	quiver
交响乐	symphony
获利	proceed
晴天	fine	sunshine
笑容	smile
（反应）产物	resultant
排列	combination	disposal
（四周有围墙的）拍打回力网球	racket
卫生间	bathroom
涨潮	flow
含蓄	implication
无表示	silence	silence
随员	attendant	servant
累赘	bother	drag
叛逆者	rebel
宣言	declaration	testimony
〈美〉拳击场	saucer
方式	fashion	form	how	manner	mode
面貌	aspect	feature
抽象派艺术作品	abstract
节日	day	festival	holiday
放纵	abandon
品位	style
[航]系缆柱上的一圈缆索	bitter
克服	victory
棘刺	thorn
款项	clause	money
债务	debt	liability	obligation
尤指计算机或计算机系统的）崩溃	crash
侵略	invasion
金属丝	wire
统计	census
主权	majesty
内景	interior
裙子	skirt
抗力	resistance
球门	goal
自由党党员	liberal
有害动植物	pest
塞壬（古希腊传说中半人半鸟的女海妖	siren
脚尖	toe
主动权	initiative
假期	leave	vacation
引起麻烦的人	problem
门道	doorway
收容所	hospital
书屋	library
光亮	shine	sparkle
管区	beat
咬伤	bite
粉红色	pink	rose
存货总值	inventory
周转率	velocity
印制的广告	circular
防腐剂	resist	resistant
（由底片印出的）照片	print
施肥	feed
[马术]环骑	volt
漂亮的姑娘	doll
懂道理的人	rational
推	push	shove
节约	economy	saving	thrift
驱除	destruction
饿	hunger
[电]电阻丝	element
工程师行业	engineering
航空	aviation	voyage
俚脸	mug
饵	bait	gentle
王子	prince
饭	meal
任职期	tour
资本	capital
空话	talk
马累[马律]	male
舞台布景	scenery
一推	dig
晚饭	supper
保留	hold	reservation	retention
一掠	glance
褒奖	recognition
星期日报	Sunday
整个	whole
电视节目的总安排（或计划）	format
恭喜	congratulation
通勤来往	commute
头脑简单的人	innocent
高尚	dignity
马克杯	mug
远征军	expedition
勋章	medal
帆状物	sail
驾驶员	driver	mate	operator
脚蹬子	pedal
一批（同类事物或出售的货品）	bundle
制服	uniform
一排	procession
基本事实	ultimate
爱意	love
全市居民	city
不认识的人	stranger
尤指青少年的）野营地	camp
触觉	feel	touch
兽栏	pound
触角	horn
[数]分数	fraction
小窍门	tip
退税	drawback
[逻辑学]小前提	minor
明显	evidence
共产主义	communism
下部	underneath
羽毛球运动	badminton
混乱	chaos	complication	confusion	mess	riot	scramble	tangle	tumble	upset	disorder
没价值的东西	mud	pin
[英史]专横政策	thorough
维修	maintenance
〈美〉（委员）代理人	alternate
急速	haste
竞选提神（或兴奋）剂（一种健怡可乐	fuel
闭尿	retention
（机器、设备等的）操作员	operator
兵权	sword
空旷	open
统治权	majesty
绳索链条	tug
水库	dam
[航海]顶桅帆	royal
污垢	dirt
即将（或刚刚）结婚的女子	bride
约束	repression
[机]从动装置	slave
业务	business	transaction
那	those
羔羊	lamb
社交聚会	party	social
化钙	calcium
物理现象	physics
高涨的情绪	electricity
被极度崇敬的人[物]	god
团体	army	body	commonwealth	corporation	fellowship	gang	group	organization
咯咯的笑	giggle
叹气	sigh
水流	current
依法必须登报的声明	legal
新设施	innovation
废品	spoil	waste
寄存品	deposit
房间	apartment	room
安心	peace	relief
（身体或精神上）受到严重损伤的人	wreck
谢谢	thank
（郡、镇等）政务会	council
大众	multitude	public
隐居	privacy
〈英俚〉（主考人评定）不及格	plough
美衣	luxury
流行病	epidemic
声称	claim
本性	self	sort	interior	internal
着魔	obsession
[法]遗嘱	will
剑	blade	sword
瑕疵	bug	defect	flaw	stain	vice
剁	chop
狭长切口	slit
铅板	stereo
分界线	barrier	boundary	divide
低声说的话	aside
仗势欺人者	bully
独立	independence
烘焙	bake
技师	engineer	technician
肥肉	fat
下划线	underline
问答题	dialog
无限的事物	infinite
打倒	overthrow
同事	brother	colleague	mate
（非正式）创意人士	creative
听写	dictation
原本	blueprint
[乐]乐音	tone
（总体、层次）结构	architecture
海域	water
帮助	assist	assistance	boost	hand	help	aid
周六	Saturday
智慧	brain	mind	wisdom	wit
忘却	silence
洗澡	bath	dip
体（板球或棒球）攻球的一方	in
显著	importance
题目	theme
老年	age
零料	remnant
证明书	certificate
发牌	deal
保守党支持者	conservative
金字塔	pyramid
镀锡薄钢板	tin
学报	transaction
编者	editor
输入	import	input
似鼠动物	rat
新加入某组织（或机构、宗教）的人	initiate
成年人	grown-up
平衡	balance	proportion
摆渡	ferry
（尤指网球比赛）种子选手	seed
陛下	majesty
套装	suit
（恒星、行星等的）合	conjunction
英俚解雇	sack
学术权威	authority
竞赛	contest	game
震动	shake	shock	tremble
〈美俚〉棒球	pea
隐喻	metaphor
照相机	camera
有益的活动	employment
火把	torch
主要成分	basis
秤盘	pan
集会的公共场所	forum
言外之意	implication
短棍	bat
实行	administration
主食	staple
校勘	criticism
机械般的人	machine
增长	growth	access	advance	increase
共和主义者	republican
乐句	phrase
（条形的）堆	bank
[植]球芽甘蓝	sprout
（尤指房间、烟囱、炉子等供暖系统中的）（小股）气流	draft
网	net	network
罐	pot
斜纹	bias
露齿而笑	grin
〈美俚〉眼镜	window
保险丝	fuse
俱乐部	club
运货汽车	lorry
保险业	insurance
报仇	revenge
炮位	battery
暗室	lab
隆起线	ridge
工作日	weekday
报价	estimate	quote
炊具箱	canteen
进取心	enterprise
（比赛、音乐会等的）半场	half
吹风	blow
制定法律	legislation
苏打水	soda
罪	debt
方丈	superior
区域	area	belt	reach	zone
空投	drop
专利证	patent
激动不安	fever
改良措施	improvement
俚钱	cabbage
控制台	console
十岁	ten
一群男人（或女人）	guy
（尤指吸引人的）相貌	look
莫斯（男子名）	moss
明信片	card	postcard
动力	dynamic	locomotive	momentum	impetus
自动化（技术）	automation
（大学的）讲师	professor
[语法学]关系词	relative
音乐（喜）剧=musicalcomedy	musical
盗版者	pirate
比例	percentage	ratio
着色剂	stain
小国的君主	prince
先驱	messenger	van
台风	typhoon
伤痕	bruise	scar
呜咽（声）	sob
薄涂层（尤指涂料）	wash
丧失（名誉	bankrupt
图书出租处	library
听写测验	dictation
草地	grass	lawn	meadow
投票	ballot	vote
精锐	elite
菜肴	menu
太太	wife
西南部	southwest
雨天	rain	wet
就职	installation
十二级风	hurricane
巡逻	patrol
玩偶	doll
指导原则	dictate	guideline
脑袋	skull
腕关节	wrist
帝国	empire
斗士	militant
洗劫	sack
俚棒球场	orchard
说唱音乐	rap
凶兆	threat
足够（的量）	sufficient
巫术	magic
[体]棒球运动	baseball
管辖的范围	reach
持续	duration
清新空气	ozone
轶事	anecdote
惯于晚上活动的人	owl
（篮球运动的）篮	basket
钢盔	helmet
书房	study
车辆	vehicle
必不可少的事物	must
（动物的）崽	offspring
弓形	arch
受人喜欢的人（或物）	peach
民主政治	democracy
发牢骚	murmur
素材资料	stuff
耳语	whisper
合伙人	associate
享受	luxury
秘密策略	wire
易冲动	temperament
百年	century
相似的情况	analogue
投机取巧者	operator
一带	surroundings
出行	trip
货单	manifest
一帮	bunch	crew	tribe
扈从	dependent
同盟	coalition	federation	union	alliance
从高处眺望到的景色	overlook
英尺(=12英寸或30。48厘米)	foot
售票员	conductor
所需时间	time
餐馆	restaurant
蔑政客	politician
联合抵制	boycott
火炬	torch
民法学者	civilian
到来	advent
岸上的沙子和卵石	beach
态度	attitude	bearing	behavior	manner	position	posture	expression
箭筒	quiver	quiver
渴望得到的东西	ambition
（第一次世界大战中指）加利波利半岛	peninsula	peninsula
十五世纪	fourteen
用作掩饰的事物	mask
汗水	sweat
（织品的）质地	substance
大意	drift
一大批	array	shower
擦	scrape	scratch	wipe
[古]奋斗	strife
（对…的）准备	preparation
孤注一掷	nap
（英美的）空军大队	group
衰退期	evening
鸟	bird
美感	aesthetic
（管乐器的）活栓	valve
课题	project	study
卖国贼	traitor
[电]信息转移通路	bus
提高	boost	hike	increase
[物]偏心轮	eccentric
角状物	horn
英细铅字	ruby
营救[救援]行动	rescue
鸡	chicken
黄色颜料	yellow
（加入组织或做某事付的）费	fee
（正式）提出	tender
附属企业	affiliate
太阳	sun
（特别的）才能	genius
鸽	dove
录音机	recorder
摸索	grope
树脂	pitch
…的化身	vessel
酒吧间	bar
联合	coalition	combine	conjunction	union	alliance	association
应得的赏罚	desert
（尤指被视为没有某人或某物那么好的）种类	like
公分	centimetre
黏土	clay
相等的数量	equal
（价格	tumble
擦皮鞋	shine
羞愧感	shame
阴性词	feminine
购买的物品	purchase
书信	communication
（周围的）环境[事物]	surroundings
职工	employee
管理者	governor
妥协	composition	compromise
新生	fresh
跳舞	dance	hop
隔板	ceiling
封条	seal
幻想作品	fantasy
雪	snow
雨	rain
绿色的衣服	green
零	nothing
内科（治疗）	medicine
商标	chop
雾	fog	steam
立交桥	overpass
笔迹	handwriting	writing
散步	outing
学识	scholarship
〈口〉（凸出的）大肚子	corporation
攻读学位者	candidate
啤酒	beer
求爱	address
纬线	parallel
地方	place	where
餐巾纸	napkin
匕首	knife
精神变态者	degenerate
（宇宙飞船上各个独立的）舱	module
宝藏	treasure
（绳索等）松弛部分	slack
同甘共苦的伙伴	companion
命中注定的事（尤指坏事）	fate
小孩	child
（地面的）裂口	gulf
（书报的）插页	insert
偶然的行动	random
短促的敲打（声）	knock
卷起	tuck
[语]闭锁音	shut
平均估价	average
解决	resolution	settlement	solution
着色者	painter
飞机	bus	plane	aeroplane	aircraft
[航]船具	hamper
（架设天线、支撑帐篷等用的）牵索	guy
阔步	stride
纠正办法	remedy
创伤	smart	wound
智力等）的人	bankrupt
汽船	steamer
[化]色淀	lake
退职金	bonus
有价值的物品	commodity
瓷餐具	china
天	heaven
寒冷	chill	cold	frost
口误	mistake	slip
没有固定工作的劳动者	casual
口语	bat
导弹	bird	missile
治安	peace	police
餐具架	buffet
重整的信号	rally
轻拍	pat	tip
词典	dictionary
成批作业	batch
尖叫声	scream
语族	family
（美国、加拿大的）一分钱	penny
几何图形	geometry
锻造车间	forge
义愤	outrage
[生物学]最适度	optimum
压力	logic	pressure	stress
夜	dark	night
呷的动作	sip
郡民	county
平常人	anybody
纽扣	button
继电器	relay
（动植物分布的）圈	realm
收回	reclaim
[逻]换位（法）	conversion
门厅	lobby
大喊	cry
春季	spring
器具等）一套	suite
事实	fact	reality	truth
兵器	steel	weapon
[计算机科学]字符串	string
受托基金机构	trust
时髦人士	modern
球	ball	globe
悠闲	leisure
灰色	ash	grey
窝囊废	wet
简单的小测验	quiz
通货膨胀	inflation
接触	contact
[军]左翼	left
舱室垫板	ceiling
发生	evolution	occurrence
（建筑物内、家具或地板等上的）灰尘	dust
脚后跟	heel
意图	meaning	view	intention
漂移	drift
干杯	rouse	toast
投票权	ballot	vote
遮阳	shade
裁定	verdict
[法]证据	exhibit
接见	audience	interview
〈美俚〉牛奶	chalk
百叶窗	blind	shutter
色鬼	goat
骰子	die
标语	banner	slogan
[法]抵押权	pledge
〈美〉（头两个球把十柱打得）全倒	spare
准	true
卓越	distinction
一时的放纵	fling
杀人（罪）	blood
条板	strip
除外	exception
字面意义	letter
手术台	table
避难者	refugee
海员	sailor
圆满	perfection
（食用）肝	liver
船闸	lock
汽水桶	fountain
信封	envelope	stationery
矿井瓦斯	damp
诉诸	resort
管纱	cop
[法]受监护人	ward
利息	dividend	interest
星期二	Tuesday
损失	loss	ruin
星期五	Friday
功能	function	action
莫名其妙的话	jargon
[矿]石英	quartz
影响	effect	impression	influence
宣誓	swear
微小模型	miniature
普通日	weekday
谋杀	murder
电气技师	electrician
[植]海石竹	thrift
壁垒	wall
[航]跨绳	span
[数]关联	incidence
大红色	cardinal
控诉	complaint
麦芽床	couch
（应对紧急情况的）演习	drill
纠纷	complication	tangle
药草	herb
毒剂	toxic
紫外线辐射	ultraviolet
一英尺有12英寸）	inch
尼古丁	tar
轰炸员舱	greenhouse
脱衣舞女	exotic
舶来品	exotic
审计	audit
（个人的）最高水平	best
出版物	press	publication
巧合	coincidence
一舐的量	lick
（用于建筑或制作物品的）树木	timber
雨燕	swift
联谊会	social
否决权	veto
诡计	cunning	deceit	fetch	game
（森林似的）一丛	forest
航空学	aviation
无辜者	innocent
保育员	nurse
烦闷	agony	disturbance
反映	mirror	reflection
（蔬菜	skin
（隔离两个表面的）垫	cushion
宿命	fate	weird
一回	once
街区	block
胸怀	bosom	breast
要素	basic	being	dominant	element	momentum	primary
部族	tribe
电报	telegram	telegraph	wire
八人划船队	eight
凸肚形	bowing
治疗	therapy
财政困难	difficulty
传动	drive
参观	visit
插曲	episode	symphony
扇子	fan
对照物	contrast
[哲]主观	subject
（拌有肉、鱼、奶酪等的）混合色拉	salad
引语	preface
[动]喜鹊	pie
行为失检	lapse
果园里的全部果树	orchard
[数]期望值	expectation
疗效	therapy
傍晚	dusk	eve	evening
乱丢	shy
古怪的人	eccentric	fantastic
（建筑物等的）周围	outside
拿取	fetch
卷曲物	curl
歌剧业	opera
显要人物	notable
航天舱	capsule
清晰度	clarity
海拔	height
门外汉	layman	stranger
（婴儿）奶瓶	bottle
电压	voltage
扫兴	chill
〈美俚〉棒球队	gang
流放	exile
[天]矮星	dwarf
令人兴奋的事	excitement
鸡蛋	egg
（船航过时的）尾波	wake
被状物	quilt
旱季	drought
议事厅	chamber
官僚政治	bureaucracy
一阵哭泣	weep
参加者	participant
紧急情况	emergency
升降机	hoist
稳定（性）	stability
裂口	rip	yawn
小插曲	incident
额外费用	premium
开关	switch
测量的标准或范围	gauge
公文包	briefcase
捕获量	catch	take
今日	today
汽车车尾的行李箱	trunk
成色	metal	alloy
损毁	damage
紧抱	hug
爱好运动的人	sportsman
祸患	disaster
处理者	manager
飞行术	aviation
[乐]速度	tempo
女巨头	princess
酒店	hotel	pub
膝盖	knee
全速	career
[印刷]校样	revise
日用品	commodity
尤指提供如秋千等设备的户外场地	playground
里格（长度单位	league
割后再生的草	fog
紧抓	clutch
洼	fold
比较级	comparison
牛仔裤	jeans
关系者	participant
（战争	outbreak
威力	logic	might
全音程	tone
构成	formation
标题	heading	title	topic
犬吠声	bark	bay
照管	trust
各种猫科动物	tiger
感化	reclaim
熔铁上的浮渣	skull
管子	pipe
平稳时期	plateau
（身体的）发烧	heat
拷问	torture
（声、光、热等的）反射	reflection
丑行	scandal
笔法	pen
（法庭上证人的）证词	testimony
畜生	cattle
轮班	spell	tour
内阁	cabinet
潜能的事物	potential
（仲裁人、公断人的）裁定	award
诚挚	earnest
装置	appliance	device	fitting	gear	setting	unit	installation
反对的话	objection
类别	bracket	category	classification	range	sort
侵犯	invasion
大陆	continent	mainland
（个人	wardrobe
（为吸引买主等而对某物进行的）包装(package的名词复数)	packages
苹果树	apple
事变	incident
进步分子	progressive
腰部	middle	small	waist
（乐队）指挥	conductor	direction
孪晶	twin
大型雄性动物	bull
《格利佛游记》作者	swift
摩天大楼	skyscraper
龙	dragon
暴发户	mushroom
共同储金	pool
文献学	bibliography
顷刻	instant
掠夺别人的人	hawk
[台球]推球	follow
养鱼（龟）池	crawl
（医院里护送病人的）护工	porter
摆	pendulum
决赛	final
全音	tone
摞	pile
活动力	activity
脚蹬	cripple
救济金	benefit
辫子	queue
[解]大脑半球	hemisphere
腰	waist
动力学	dynamic
同感	sympathy
腿	leg
肿瘤	growth	tumour
可能的人物	possible
（金融方面）大恐慌	panic
[法]契约法	contract
上校	colonel
弯道	bend
管理人	manager
背景	context
同意	approval	consent	okay	yes	agreement
语境	context
摆程	swing
单调的生活	vegetation
[姓氏]斯威夫特	swift
呼啸声	roar
腕	wrist
住处附近的当地酒店	local
拒绝参加	boycott
梨树	pear
零头布	remnant
（轮船的）机师	engineer
报复	revenge
博物馆	museum
传授的或获得的知识	instruction
凭借	resort
通道	corridor	door	pass	passage	aisle	exit
祈祷	prayer
新梢	sprout
（纵横填字谜、游戏或问题的）提示词语	clue
计数器	counter
小说的）情节的征结	knot
地区	area	locality	neighborhood	quarter	region	zone	district
本源	source
镭射器	laser
妙计	wrinkle
灾变	catastrophe
极艰难[令人沮丧]的经历	murder
限度	limit	tolerance
本土	mainland
社会学	sociology
寓言	fable
多样	variety
谄媚者	creep
失散	wander
典范	pattern	pink
环外命中	outer
戏剧效果	drama	theater
洗发剂	shampoo
款待	banquet	entertainment	hospitality	treat
（球场）边线	boundary
预防	precaution
不相连的一块	fraction
最合乎要求的事物	best
憾事	pity
朋友	friend
榨取别人血汗的人（或工厂、公司等）	sweater
苦恼	anguish	agony
模块	module
自动调节（把机器的输出数据提供给自控装置以纠正偏差）	feedback
单飞	solo
神父	priest
刻苦	pain
（精力、时间、材料等的）耗费	expenditure
深色	brown
联系	connection	relation	relationship	association
下属	inferior
某类	kind
[计算机]运程	remote
[语]宾语	objective
决定	conclusion	decision	resolve
奖章	badge	medal
乳牛	cow
邮件	mail	post
最高部	roof
翼	limb	wing
人口财产调查	census
（有盖的）大篮子	hamper
航海（术）	navigation
滴答滴答的声音	drip
从外围经过	outskirts
客体	object
记载	catalog	record
矿物质	mineral
空的空间或地点	blank
匮乏	pinch
装饰	dress	ornament	paint
拉丁文学	Latin
代替者	substitute
持久（力）	endurance
自负	boast	ego	vanity
恢复	recovery	retrieve
退场	exit
附近	suburb	vicinity
侄子	nephew
高压地带	high
钟状物	bell
研讨会	seminar
屏幕	monitor	screen
码（等于3英尺或36英寸或0。9144米）	yard
（学术的）部门	realm
星期天	Sunday
群落	village
类似地图的事物	map
野生种	escape
引起兴趣的东西	relish
暧昧不明	blur
（身体或心灵的）剧痛	sting
工作平台	environment
最大的量、体积、强度等	maximum
（尤指向地方性电视台）馈送电视节目	feed
境	region
推断	guess	inference
（尤指非正式的）谈话	chat
泥淖	mud
自贬	stoop
逃跑工具或方法	escape
光棍	kite
盘问	challenge
（圆形器皿的）边	rim
碗橱	buffet
墙	wall
势力范围	orbit	sphere
怠慢	neglect
临床讲授	clinic
空白	space	vacuum	white
利用	improvement
手提包	briefcase
基本规律	basic
小汽车	compact
占有	occupation
时髦	trend
难懂的话	jargon
腐烂	rot
梳洗	toilet
轮廓鲜明的突出体	angle
自动售货商店	supermarket
惋惜	regret	sorrow
准备工作[措施]	preparation
奖金	bonus	subsidy
综合体	synthesis
雪季	snow
[商]商标	brand
泡沫	foam
盔形物	helmet
能力	efficiency	facility	faculty	grip	quality	ability
律占用者	tenant
一片	forest
纸巾	towel
最后部份	ending
翎毛	feather
应用	application
管理费用	overhead
不流行	out
影子	shadow
侵害版权者	pirate
感觉最敏锐的地方	quick
有效期	lifetime
[乐]节拍	rhythm
主因	dominant
八月（简写为Aug）	August
答复	reply	response
癖好	tendency
入迷的人	addict
（昆虫的）幼虫	worm
手势	gesture	motion	sign
自助餐	buffet
书斋	library
美国南方各州	south
过道	hall	aisle
金属钱币	coin
打听	inquiry
轴心国	axis
精选品	choice
<英·非正>玩笑	giggle
汇合点	meeting
暖和	warmth
[复数]各位	guy
（电缆等的）主结点	junction
西南	southwest
扫描	scan
苦啤酒	bitter
（在公司、计划等中的）重大利益	stake
班长	monitor
[数学]约简	reduction
（常小写）（对神的）感谢	Thanksgiving
逢迎	jolly
伤害的行为	injury
<口>水手	tar
肥皂剧	soap
口生命	hide
瀑布	waterfall
平面图	plan
尺子	rule
（书等的）目录	content
报考者	candidate
（价格、价值的）上涨	advance
袭击	assault
无耻	assurance
[语音学]音长	duration
纠缠	tangle	implication
定期刊物	journal	serial
（美）装修	improvement
（电视与计算机）网络	network
圈子	circle
革命	revolution
原[生]材料	crude
靴面	upper
创造物	creature
（做某事的）道理	logic
遥控装置	robot
昵称	nickname
定罪	conviction
斩首	heading
[机]轴套	boss
买卖	buy	trade
产业（经济词汇）	industry
刑柱	stake
（根据权利而提出的）要求	claim
普赖尔	prior
冷藏箱	safe
危难时刻	crisis
额外股息	bonus
叉状物	fork
〈美俚男子假发	rug
住户	inhabitant
局外人	stranger	alien
[印	beer	tow
公鸡	cock
当代人	contemporary
描述	description
选择	choice	pick	selection
[犹太教]犹太教聚会	temple
坡度	tilt	incline
（感情	explosion
〈口〉游览	cruise
奉承	jolly
适应	accommodation
诗歌	poetry	song
更换	shift
有限性	finite
士兵	private	soldier
自命不凡	inflation
花房	greenhouse
下流想法	dirt
环形交通枢纽	roundabout
浏览	browse	dip	glance	scan
保暖罩	cosy
维他命	vitamin
假象	pretext
（特指）那	those
顺差	surplus
配给券	coupon
（舰队或军队的）后方	rear
一块烤肉（英式英语）	joint
焊膏	butter
失业期	layoff
围攻	siege
某国国民	national
[建]球饰	balloon
油漆匠	painter
陷	bug
赦免	pardon
进款	income
（乐器的）音	speech
终止	end	shut
健身房	gymnasium
塑料制品	plastic
记忆力	memory	mind	recall	retention
贫瘠	poverty
合金	alloy
雌鹅	goose
（电波的）波束	beam
球场	pitch
勤劳	industry
芳香	nose
舷弧	sheer
受伤处	injury
教学	tuition
耐用品	durable
恶习	vice	abuse
引擎	engine
〈英俚〉侦探	busy
〈古〉节俭的管理人	husband
握住	hold
吼叫声	roar
车	car
（表面的）诱惑力	glitter
先祖	ancestor
宝贝	jewel	sweet
轿	litter
抱怨…的原因（理由）	quarrel
轴	axis	shaft
半导体收音机	transistor
散播	scatter
[戏	exterior
[方]笨蛋	put
指环	ring
挤压	squeeze
日记簿	diary
感动	emotion
八孔直笛	recorder
反驳	contradiction	retort
弊端	disease
镜子	glass	mirror
迁移	move
令人惊奇的事（或消息等）	surprise
轴踵	toe
剧照	still
[生]交合	intercourse
罗马数字1	I
[影视]外景	exterior
假货	junk
口飞机	bird
前任	predecessor
难对付的人	nut
酗酒者	drunk
文摘	digest
口宇宙飞船	ship
倒转术	version
不法所得	grab
次要方面	accidental
水湾	inlet
鱼秧	fry
总理	premier
原件	original
委托人	constituent
环行交叉路	rotary
美须穿礼服的社交集会	formal
供乘骑的游乐设施	ride
珍宝	treasure
（财势的）显赫	prestige
桥面	deck
血液	blood
穿戴物	wear
任务	assignment	objective	task
古希腊与古罗马的文化研究（尤指对其语言与文学的研究）	classic
观众席	auditorium
地铁	subway	tube	underground
大街	avenue	street
火柴	match
共轭（马、骡）	span
小费	fee	tip
拘束	chain	restraint
打字员	typist
和睦	peace
兽	animal
警报	alarm	alert
修道院院长	superior
漂亮的东西	lovely
马车的车顶	imperial
记事	narrative
标售	auction
六	six
〈诗〉青春	May
吊窗	bay
八	eight
文艺（包括绘画、雕塑、建筑、音乐、舞蹈、戏剧、文学等）	art
代价	cost	price
[复数]战事	arm
图片	picture
鼠标	mouse
碍手碍脚的人	passenger
原动者	motor
党	party
大学肄业生	undergraduate
船运货物	freight
弗兰克	frank
启发	suggestion
克	gramme
农场	farm
掌声	applause
故事	narrative	story
最近	tomorrow
裁定书	award
[数]有理数	rational
听力	ear	hearing
非正式的货币	fantasy
（打印机的）色带	ribbon
现代化的事物	modernization
会演	festival
[植]叶脉	nerve	vein
船长	captain	officer
镇压	repression
[无线]干扰	jam
苦活儿	grind
服务台	desk
忠实信徒	loyal
感激	gratitude
星期一	Monday
本金	principal
滴答	drip
剧本、广播稿或者电影剧本	script
余额	remains
空的东西	empty
[人]斯威夫特	swift
街道	street
烟雾	fog	fume	smog
信徒	christian	faithful	fold
横行霸道者	bully
煤车	tram
（教堂	gallery
坚强	iron
热烈欢迎或赞同	acclaim
[虫]保护虫	nurse
喇叭声	tuck
荷重	cargo
到达	arrival
[植]沙果	crab
名词词性	noun
煤堆	coal
季节性竞赛	campaign
代表团	mission
绷带	bandage
衬里	liner
分娩	birth	delivery
（大院内的）单幢住宅	cottage
称重量	weigh
足球〔美国通常指橄榄球〕	football
特别基金管理机构	fund
布告	declaration	notice
口腔顶部	roof
加价	raise
共鸣	echo
音量	volume
女主人	hostess	mistress
口偷懒	soldier
华样	sample
快速	speed	velocity
常作mysteries秘技	mystery
唯物论者	physicist
摄影胶卷暗匣	cassette
年少者	junior
晚餐会	supper
委员	commission
郊野	countryside
遗骨	remains
黑人	Negro	black
地皮	site
堡垒	castle
时间的长短	length
缘故	sake	score	cause
蓝紫色	violet
苹果公司	apple
组分	component
和包或钱袋相似的东西	purse
失败	defeat	fail	failure	loss	reverse	stumble
老奶奶	grandmother
专有物	exclusive
有吸引力的人或物	magnet
巨响	bang
屠宰（动物）	slaughter
抚慰者	physician
憎恶	hatred
家庭妇女	housewife
[法]宣誓	oath
体育家	athlete
不及格	fail	failure
毛衣	sweater
英雄诗	heroic
宫廷	court
油墨	ink
质问	inquiry
海	sea
工厂	factory	manufacture	mill	plant	shop	work
憎恨	despite
操作	operation	work
（牛津大学的）校工	scout
饥荒	famine
物半导体	semiconductor
〈口〉大意	hang
志向	aim
一套服装	outfit
[军]师	division
通常是23×23英寸	imperial
慌乱	tangle
陶器	china
同行	colleague	profession
[占星学]星力	influence
情报机构	intelligence
障碍（物）	obstacle
（行李）搬运车	truck
研究者	student
（组织、制度、信仰等的）核心	pillar
煤矿	pit
[印]出血版	bleed
[常用复数][法律]受让人	assign
吸引	invitation
遮光涂料	opaque
责任	blame	burden	duty	fault	liability	need	obligation	responsibility
五十年代	fifty
蛇形浮动汇率制	snake
[乐]键盘	manual
深度	depth
[计算机]链接	link
程度	degree	measure	pitch	extent
教化	civilization	reclaim
[物]浓度	density
时尚界	fashion
（人的）表面性格	shell
驻军	stationary
教区	district
程序	procedure
矩形	rectangle
[乐]舌簧	reed
构件	member
接受敬酒的人	toast
两极端	pole
糨糊	paste
现金	cash	stuff
[经济学]生产率	productivity
学术奖金	fellowship
（批评、判断等的）标准	criterion
栎木	oak
周报	weekly
口号	slogan
主办者	sponsor
热烈	glow	heat
领带	tie
英女教师	mistress
老师	sir	teacher
（故事的）结构	mechanism
规模	scale	size
隐形眼镜	lens
放逐	exile
天桥	overpass
压阵队员	anchor
支配	rule	sway
[无线]自动搜索干扰振荡器	broom
自由式游泳	crawl
[医]点滴	drip
公开辩论	controversy
女职员	girl
反叛者	rebel
鼓	drum
工业界	industry
名字	name
（雕塑等的）群像	group
领土	territory	domain
衣褶	gather
克里斯琴	christian
编织式样	weave
病毒	virus
海湾	bay	harbor	gulf
教训	lecture	lesson	moral
巧克力糖	chocolate
（牙科用的）橡皮障	dam
电影艺术	cinema
空虚感	void
租借地	concession
饰扣	frog
一杯（的量）	cup
接受财产等转让的人	assign
心理状态	psychology
[印刷]草书体大号铅字	secretary
捐献	donate
（事物的）反应	behavior
晚辈	junior	inferior
概观	survey
（尤指充满惊险的）故事	tale
环境因素	nurture
临时工人	casual
旗	banner	flag	standard
全体职员	staff
假面具	mask
输入的数据	input
举动	handle	movement
吸引力	glitter	lure
使命	message	mission	vocation
（大学的）学院院长	dean
总括	umbrella
很多	bag
位置	lie	locality	location	position	site	situation	slot
管状物	tube
次序	order	rank
前置词	preposition
封皮	envelope
发音	pronunciation
扬场器	loudspeaker
演变	evolution	variation
电车	trolley
破裂	breach	break	fracture
人道	humanity
戒指	ring
绊（使某人跌倒的动作）	trip
运行	revolution
臂	arm
哽咽	choke
女人	female	hen	woman
昼日	daytime
（歌曲的）副歌	chorus
空调系统	air-conditioning
〔电〕电流	circuit
（广播、电视节目的）一期	edition
your	all
金色	gold	metal
收割	harvest
人品	personality
女式短茄克衫或前开襟毛线衫	shrug
吸管	straw
夹子	brace
短袜	sock
耳状物	ear
展览品	display	exhibit	exhibition
毫米	millimeter
宁静	quiet	rest
（骰子	cater
幻影	vision
争端	dispute
小艇	boat
渠道	channel	route
道谢的话	thank
耙子	rake
施舍	charity
交通违规的通知单	ticket
穿着	wear
包袱	burden	parcel
婴儿食品	formula
正确	right
创造者	architect	author	author	former
[军]（向占领地人民征收的）军税	contribution
后裔	descendant
诗人	poet	swan
罚款	fine
迷	fan
神职任期	ministry
东亚各国	orient
会议	conference	convention	meeting	session
长途客运汽车	coach
水果	fruit
知情	know
自己	self
楼塔	tower
办事处	shop
包袋	envelope
工业工人	industrial
纪律	discipline
钉状物	nail
（大地的）产物	fruit
专卖	monopoly
美烧烤会餐	bake
辩论	debate	debate	dispute
管辖范围	domain
一连串景象或事	panorama
下腹	abdomen
较年长者	senior
（教育、专业等）机构	institute
堰	dam
当心	care
堆	heap	mass
交流	communication	intercourse
（外交等的）方针[态度]的确定	orientation
被继承人	ancestor
Lab	lab
损坏	breakdown	casualty
（英国以外的）伯爵	count
（支票等）持有人	holder
毒物	toxic
额外	over
展览艺术品的小陈列室	cabinet
织布法	loom
供应船	tender
重要	magnitude	moment	weight
百分数	percent	score
倒转	reverse	inverse
厨师	cook	kitchen	chef
魅力	charm	grace	lure	spell
暗号	sign	signal
速度快的谈话	rap
〈俚〉地面	deck
用法	usage
观光客	tourist
横幅	banner
缺勤	absence
大人物	somebody
眉	brow
看	look	regard	view
[动]黑脉金斑蝶	monarch
谴责	ban	reproach
[航海学]码头边的木靠把	camel
舞蹈艺术	dance
现代主义者	modern
领袖	boss	captain	van
最后期限	deadline
专利	patent
顾虑	concern
听众席	auditorium
文具	stationery
允许	permission
俚畜生（一般的人）	animal
大教堂	cathedral
（公共汽车、卡车等的）车库	barn
围捕	raid
网球等发球	serve
扭伤	wrench
讲某种语言的人	speaker
变量	variable	variation
〈美俚〉匪帮	mob
原始思想	beginning
所有	ownership	possession
蝶泳	butterfly
褐色（或棕色）的衣服（或织物）	brown
人生或历史上的重要时期	chapter
胶卷盒	magazine
功绩	feat	merit	exploit
卷入	implication
画法	pencil
受雇陪同某人外出社交的人（尤指女人）	escort
工艺学	technology
食欲	appetite	belly	stomach
抚摸	caress
[生物学]（微生物等的）培养	culture
保守的人	conservative
吝啬鬼	screw
外来物	foreigner	exotic
空间	room	space	vacuum	clear
天命	destiny	vocation
窗户	window
无价值	absurd
监督	scrutiny	ward
规则	order	regulation	rule	imperative	statute
宪章	charter
挂钩	catch
标准化	normalization
亲缘植物（或动物）	relative
（财富等的）滚滚而来	stream
七月	July
歌手	swan
喀哒声	click
诽谤	scandal
实质	essence	meat	substance
机械	machine
剃刀	razor	shave
书籍的护封	jacket
不利条件	handicap
敌方	hostile
富有机智的人	wit
确实性	certainty
阻碍的行为或例子	obstruction
有利	commodity
价格表	tariff
保险	insurance
脊椎	spine
咕哝	murmur	mutter	rumor
必须做的事	must
动物之偶（尤指鸟类）	mate
相关物	correlate	relative
主要管道	main
语言文字	language
树状图	tree
尺寸	dimension	measure	size
[植]花叶病	mosaic
篱笆	fence
高度	height	altitude
果肉	flesh
心理特点	psychology
为一镑的二十分之一）	shilling
三十	thirty
浮板	float
碰撞	bump	collision	foul
[林]先锋树种	volunteer
离开	departure
[物]磁体	magnet
戏剧文学[艺术]	drama
[植]风散种子	parachute
住处	dwelling	habitat	residence	accommodation
变性者	invert
[人名][英格兰人姓氏	Easter	Easter	Easter
钟头	hour
棒球	baseball
滋养	nutrition
楼梯间	staircase
[乐]延长号	pause
实际存在物	entity
〈英〉边境（线）	mere
黑板	blackboard
末期	evening
预报	forecast
势头	momentum	impetus
推理方法	logic
冒险的事	hazard
<宗>洗礼盆	lavatory
弯曲物	curve
隐蔽	cover
更优秀的人	improvement
泻盐	salt
搅拌金矿的铁器	paddle
消极性	negative
免除	relief
成员	member
工程（学）	engineering
赌注	bet
（海上）导弹	bat
颗粒	particle
地球仪	globe
表示	testimony	expression
人造卫星	satellite
灌木（丛）	bush
失足	lapse	slip	stumble
垃圾	garbage	litter	refuse	rubbish	trash
构造	build	fabric	structure
垂足线	pedal
积雪	snow
分类	classification	sort
电力	electricity
迎接	welcome
绳子	string	tie
发令枪声	gun
收据	receipt
低声说话	murmur
奇观	spectacle	wonder
看守矿井的人	policeman
水滴	drip
常态	normal
（兴趣或活动的）范围	sphere
级友	classmate
佳人	lovely
雨伞	umbrella
巨蟹宫	cancer
要略	analysis
（棒球等的）弹跳	hop
气味	odor	scent	smell
顿悟	insight
所请求的事物	request
差错	mistake	stumble
周	week
不顾	contempt	disregard
[语]阴性	feminine
结婚纪念日	wedding
射击	fire
（衣服等的）裂缝	rent
驱逐者	driver
测量部	survey
小报	bulletin
〈口〉笨蛋	thick
抚养	keep
库存	bank	stock
成年女子	woman
粘聚力	glue
吹捧	boost
自助餐厅	cafeteria
足球运动	football
难看的人	fright
调味品	relish
（一）打	dozen
改变	change	move
揉搓之物	twist
阶层	rank
连环漫画	comic
拖延	delay
[数]加法	addition
[工会、工党用语]（每年的）大会	conference
鞋	shoe
能与之比拟的东西	equal
水手	sailor
有钱人	have	millionaire	wealthy
（节目）重演	repeat
志愿兵	volunteer
烟囱	chimney
小型考试	quiz
东北方向	northeast
小橱	locker
渠	trench
武力	force	sword
提议	offer	proposal
挥舞	flourish
（活动、注意力、兴趣等的）中心	focus
宾格	objective
惊慌	panic
蜡	wax
作诗	poetry
[物]佯谬	paradox
雪糕	ice
交叉点	intersection
预付款	advance
恶行	evil
外貌有吸引力的人	dish
（在英国对女贵族或贵族成员的妻子女儿或爵士妻子的称呼）夫人	lady
[数学]偏微商	partial
上升的暖气流	thermal
似真	likelihood
自动化机器或设备	automatic
[医]辅助呼吸的装置	lung
求交运算	cap
[生]显性性状	dominant
[医]（对伤处等的）针探	probe
（发育的）初期	blossom
[哲]现象	appearance
辉煌	bright
血气	blood
跛子	cripple
挽救	saving
说话	relation	say	speech
尖端	peak
蠢货	silly	turkey
数	number
跃起	bound
油画	oil	painting
女服务员	waitress
默念	meditation
突发的一阵	stab
海滩	beach
海滨	beach	seaside
盒式录音带	cassette
标志	significant	stamp	symbol	index
一缕	trail
印章	seal
月份	month
（幼虫的）毛	wool
人造珍珠	pearl
（心脏的）瓣膜	valve
颈前部	throat
方便	convenience
小酒馆	inn
[宗]教会	church
提桶	pail
清早	daylight
一般信徒	layman
高兴	delight	joy
〈比喻〉障碍	dam
别名	surname
（电话机的）话筒	telephone
主宰事物的力量	destiny
扩张	expansion	explosion
[数学]合矢量：等价于一组向量的一个单个向量	resultant
少年	lad	youngster	adolescent	boy
极端自私的人	me
语代词	pronoun
寄生虫	parasite	worm
发现物	find	finding
善良可爱的人	angel
潮气	vapour
白色	white
（动物的）原种	ancestor
鹅肉	goose
（俚语）撒尿	leak
客气	ceremony
迂回管道	bypass
反向	reverse
[植]自生植物	volunteer
（债务的）清偿	satisfaction
女式斗篷	cardinal
阵列	array
抹布	wipe
刮胡子	scrape
[航]翼型	profile
武装力量	military
亲属关系	kin
启幕	curtain
涨价	hike
拳头	fist
琴键	keyboard
臀部	bottom	hip	rear	seat
（动物的）栖息地	habitat
烟雾等）	puff
超声波	supersonic
混录	mix
纠缠不清	coil
（展览会	jury
[古语]平民	vulgar
上升	hike	up
（性情）暴躁	temperament
理科	science
光明	light
同样的人	equal
爆炸物	explosive
体积	volume
后代	daughter	offspring	descendant
想当然	assumption
起草者	drawer
艺术	art
界面	interface
（计算机文件或程序的）目录	directory
兴旺时期	blossom
仓库	dump	storage	warehouse
外形	form	outline	exterior	profile
任何地方	nowhere
柠檬树	lemon
赠送	gift
维	dimension
孤儿	orphan
套筒	boss
涂层	couch
技术人员	technician
[物]量纲	dimension
叛乱	rebellion
小山羊皮制品	kid
组	group	team
戏剧	drama	play	stage
经常发现某种事物的地方	habitat
添加物	insert
结	knot
供给物	supply
苹果	apple
橙色	orange
灾害	plague
瞄准	present
〈诗〉深海	profound
（工人间的）伙伴	mate
重量	weight
词句	expression
分句	clause
（纸牌中的）老K	king
秘诀	key	mystery	recipe	secret
人体	dust
信息库	database
储存	reserve
腹腔	abdomen
难度	difficulty
基督降临（圣诞节前的四个星期）	advent
合唱歌（曲）	chorus
（轮船上工作或生活的）隔间	cabin
泡影	bubble
（尤指集体）远足	excursion
茶树	tea
值夜	watch
侧廊	aisle
战舰	warship
阻碍	block	brake	obstruction	rub	setback
旅行包	mail
轻而易举的事	breeze
高飞范围	soar
〈口〉须警惕的事或人	caution
资格老的	elder
[语法学]定语	attribute
肝脏	liver
手术刀	knife
[法]殴打	battery
基数（如十进制的10和二进制的2）	base
橡木	oak
紫外光	ultraviolet
取向	orientation
接纳	acceptance
算法	arithmetic
便笺簿	tablet
挣扎着慢慢前进	limp
助学金	subsidy
卷烟	tobacco
尾部	tail
琐碎东西	small
椭圆	oval
锚状物	anchor
粗绳	rope
强度	intensity
填充物	stuff
交易开始时间	opening
建造物	construction
口香糖	gum
神话	myth
一面	front
小提琴手	violin
药物	cure	drug
[美国俚语]警察	badge
人烟稀少的地区	wild
[气]暴风雪	snowstorm
精神病患者	mental
传票	ticket
重新集合	rally
效忠的臣民	loyal
车费	fare
演员（尤指男演员）	actor
受骗者	fool	prey	victim
面孔	map
支座	bearing
休息日	holiday
旁道	bypass
浴缸	bath
崇拜	praise	worship
委员会	commission	committee	council
青少年	junior	juvenile
娱乐	entertainment	pastime	pleasure	sport
统治	rule	sway
军衔	rank
看法）的抵触	collision
屋顶	roof
草木	plant	vegetation
[生]自然演替	succession
一砖的厚度	brick
悲惨的境遇	misery
频道	channel
支持物	brace	holder	rest
（迅速打上的）记号	pop
（工作必需的）知识	equipment
宽度	breadth	width
敌对者	hostile
许可权	liberty
市长	mayor
议员席	floor
[非正式用语]被雇佣的人	hire
污辱	reproach
措辞	expression
市镇	town
（管弦乐团的）管乐器	wind
一系列	run	succession
（手套的）拇指部份	thumb
可能有的事	possible
直升飞机	helicopter
养殖	culture
史学工作者	historian
（中等、专科学校或大学的）二年级学生	sophomore
值得买的东西	investment
礼拜五	Friday
[军]<俚>周围有玻璃的座舱	greenhouse
（足球运动的）旋球	spiral
仁慈	kindness
简单	simplicity
家属	household
菱形	diamond
（尤指天主教和东正教的）神父	father
攻击	assault	attack	strike
堂皇	royalty
杂音	hum	noise
车头灯	bright
上品	extra
[复数]秘史	anecdote
遭遇	occurrence
习题	problem
皮革	leather
窃贼	burglar
课程	course	curriculum	lesson	programme	instruction
房客	tenant
并随参赛者的进步而减少）	handicap
非正式的社交集会	coffee
否定	denial	no
令人讨厌的人	terror
移植者	transplant
借鉴	mirror
天性	kind	nature	instinct
（尤指外语考试中的）口试	oral
一季的木材采伐量	fell
截止期限	deadline
圆顶体育场	dome
包厢	balcony	box
爆炸	blast	burst	explosion
（运动员）转会	transfer
童话	fable
面包皮	crust
烟斗	pipe
喜剧	comedy
主教	pope
某些国家的)大学理事会	senate
禁令	ban
（私立学校的）校长	headmaster
法院	court
（纳税品在海关的）申报	declaration
缺乏	deficiency	failure	lack	poverty	short	want	absence
面	panel	side
英语男子名	stern
形成	formation
（吸毒）成瘾者	addict
负责任	responsibility
缝法	stitch
住院医师	resident
大农场	plantation
传送	delivery	transmission
营地	camp
[俚]老手	shark
推销术	sell
替补（运动员）	substitute
安全	safety	security
天体图	map
传递	relay
口人的皮肤	hide
弹性	bounce	give	spring	stretch
卓绝的手艺	feat
小路	lane	path	track
民族语言	speech
内情	story
待洗的衣服	laundry
片段	fraction	fragment
哲人	philosopher
少数	handful	minority
组合	resultant
名作	masterpiece
首脑	head
最高统治者	monarch	sovereign
直线	straight
豆	bean
贮液器	reservoir
客户	customer
学部	department
验尸陪审团	quest
[解]关节	joint
（市镇的）中心区	centre
得分记录	score
〈英俚〉大量	bag
观念	concept	idea	notion	sense
嫌恶	horror	disgust
象	elephant
泛滥成灾	nightmare
重要的人物	somebody
冷藏间	locker
名册	roll
抓牢	grip
议员	representative
结论	conclusion	study
手表的宝石轴承	jewel
少数民族的成员	ethnic
临时营房	hut
古一见	blush
公使	minister
画室	studio
自杀	suicide
[药]赋形剂	vehicle
令人头痛的事	headache
（马等）疾驰	gallop
善行	good	kindness
长时期	long
承蒙	courtesy
供给住宅	housing
质地	texture
打包机	compress
做事方法	process
极大的痛苦	agony
螺丝钉	screw
确定的事	certainty
项目	item
效用	avail
身分	station
交替	change
千米	kilometre
长袜	stocking
松紧带	elastic
单元	unit
王后	queen
长袍	cope	gown	robe
（智慧等的）明灯	lamp
待遇	deal
难事	difficulty	knot
内容	content	substance	inside
行政部门	executive
场所	location	seat	site	spot	where
征兵	levy
惊惧	awe
[复]面积	dimension
赌博或其他投机	gamble
弥撒圣歌集	gradual
强暴	violence
意见分歧	difference
[物]湿度	humidity
眼状物	eye
习惯	custom	habit	manner	usage
补足语	complement
山峰	mount	peak
轻浮的人	butterfly
警方	police
对象	object
[会计]分类账	journal
屏障	barrier	wall
政治家	politician	statesman
金银财宝	treasure
疏远	distance
注意	attention	note	notice	observation	remark
救助	salvation
狼	wolf
〈美俚〉女学生	cattle
培养者	nurse
仔细的观察	scrutiny
完善	perfection
混合	blend	mixture
唱片套	sleeve
责备	blame	reproach
席位	seat
东方	east	orient	sunrise
面条	noodle
可怕的事物	horror
舞台等的倾斜度	rake
举止	bearing	conduct	gesture	manner
代替物	change
婶娘	aunt
小村庄	town
由卡车拖走）	skip
（英国用以称呼法官、主教或某些男性贵族成员	lord
中庸	medium
首相	premier
[篮球]罚球区	lane
吩咐	direction
（足球彩票的）彩金	dividend
大多	mass
询问	quiz	inquiry
果实	fruit
幸免	shave
左派	left
伤口	wound
文凭	certificate
中午	noon
特质	distinction
申请书	request
祸害	curse
投资	investment
悖论	paradox
位	place
金属	metal	scarf
薪金	salary
（死一样的）寂静	dead
突击	raid
箱状物	box
似黏土的东西	clay
羽毛球	badminton
腰带	belt
代理商	agent
铸型	cast
网球场	court
阳性词	masculine
某些数量	somewhat
网络	net
不道德行为	vice
扶手	elbow	rail
（盗贼	raid
呵欠	yawn
血色	color
朗读者	reader
（道路或跑道拐弯处的）内侧	inside
四分之一	quarter
注解	note
否定的观点	negative
（咖啡树或几种其他植物的）子实	bean
支付	payment
信用卡	card
下巴	chin	jaw
独立自主的人	independent
拍打声	flap
技艺表演	feat
票	ticket
新闻	news
（金属）薄板	lame
织布机	loom
许可	leave	permit
一家[户]	door
（悬崖、峭壁的）边缘	edge
取笑卖弄风骚的人	tease
问题	problem	question	issue
流动	flow
颤抖	shiver
发音方式	pronunciation
羽毛	feather
忠诚	faith	loyalty	truth
低估	underestimate
（话或作品等的）旨趣	tendency
陈规旧习	stereotype
看见	sight
空隙	space	void	clear
刮脸	shave
当今	nowadays
平装本	paperback
（某界）巨子	king
薄片	lame	slice
宝石	brilliant	jewel	stone
奶酪	cheese
搬迁	removal
鹭鸶的叫声	bump
带状物	belt	ribbon
蒸馏器	still
兽穴	earth
高潮	bore	climax
（五朔节装饰用的）绿枝花枝	may
长期努力	siege
联合体	combination	cooperative
非法妨害	nuisance
妄用神名	oath
样板	former
泼出（量）	spill
忍耐	endurance	patience	stay
拖拉机	tractor
花生	peanut
流动工人	stiff
日子	date
手写本	manuscript
化氢	hydrogen
凸窗	bay
钻石	brilliant	diamond
三角铁	triangle
[数]无穷大	infinite
信条	belief
参考	reference
办理	transaction
丢脸的事件	scandal
被单	sheet
螺旋（线）	spiral
糖类	carbohydrate
玩弄权术者	politician
（迫切）需要	necessity
白垩	chalk
（文章的）一段	passage	patch
（练习射击用的）抛靶器	trap
纪元	epoch	era
电话机	telephone
骨骼	skeleton
获得物	acquisition
[数]原点	origin
羊毛制品	wool
身体检查	physical
机械装置[作用]	mechanism
使用能力	use
心不在焉	absence
垫子	cushion	mat	pillow
惊逸	shy
链子	chain
中风	stroke
形容	description
棘手事	handful
梅里（姓氏）	merry
怨言	beef	complaint	mutter
称心如意的人	eligible
[生]触角	antenna
奢侈	luxury
面试	interview
重物	heavy
夸口	boast
烦恼	fume	harassment	trouble	worry
（计算机的）页面	page
脸蛋	cheek
论点	score	thesis
自主权	autonomy
冒险行动	venture
后尾	rear
受精媒介物	fertilizer
轻率	haste
一会儿	tick
健康状况	condition	health
间谍	spy
一年生植物	annual
祸因	curse
中立人士	neutral
手推车	cart	trolley
拳击场	ring
题材	motive
官僚机构	bureaucracy
（女用）蘑菇形草帽	mushroom
剩余部分	remnant	rest
财政	finance
角落	corner
[美国俚语]偷窃	rip
[数学]复数	complex
一堆	pile
原理	element	fundamental	principle	theory
来源于中世纪英语	Easter
曾	seam
电子管	lamp	tube
策略性	policy
有身份地位的人	gentleman
零摄氏度	zero
（报刊的）期	issue
品脱	pint
乱写乱画	scratch
年轻人	sprout	young	youngster
[铁路]客车车顶	deck
扇形	sector
相像的人	similar
（意见	collision
制造厂	factory
小公司	minor
睡袍	robe
恐吓	menace	threat
火灾	fire
句子	sentence
城堡	castle
钢型	die
布置图	layout
起动装置	trigger
呜呜声	sing
兑换	conversion
[逻辑]个体	species
（人的）情况	situation
砖块	brick
无线电广播台	radio
远征	quest
蜂窝状的东西	comb
5美元钞票	five
相互干扰	conflict
估价（尤指估价财产	appraisal
公债	bond
海盗	pirate
法定年龄	majority
外援	aid
神灵	presence
评论员	critic
直尺	ruler
实施（方式）	conduct
淘盘子	pan
换乘	transfer
大使	ambassador
无论怎样坏	worst
很远的距离	mile
语风	language
（报刊上的）人事栏	personal
丢失	loss
引渡	tradition
船腰	waist
英寸（相当于2。54厘米	inch
档案	biography	record
[植]保护树	nurse
货栈	warehouse
如行星或恒星	sphere
举起	heave	lift
银	silver
浴室	bathroom
普通	common	ordinary
辅助者	auxiliary
脾气	kidney	strain	temper
拨款	grant
[物]清晰度	definition
销售部的两个新雇员	hire
咒语	curse	spell
瘤	knot
印刷机（厂）	press
细小部分	small
铜	copper
固定时间	hour
归来	return
市民	citizen	civilian
资料	data	data	food	stuff
〈口〉做法	hang
[罕用语]预定	destination
假说	hypothesis
股息	dividend
铃	bell
鹰派人物	hawk
（管风琴的）音管	pipe	stop
圣子（耶稣基督）	son
铅	lead
教学活动	classroom
滚翻	roll
公布	publication
歌唱才能	voice
蜘蛛	spider
指导方针	guideline
性命	life
古旗手	ancient
小雪茄烟	blunt
充裕	plenty	abundance
风气	spirit
制药业	pharmacy
索引	index
有癖好的人	fool
河流	stream
看法	attitude	esteem	judgement	perspective	posture	take
食物	bread	edible	fare	fare	food	meat	nurture	nutrition
（尤指外语教科书中附有释义的）词汇表	vocabulary
延长	extension
染色	dye
订婚	engagement
联合收割机	combine
新时代	epoch
角锥状物	pyramid
证明	proof	testimony	tribute
规矩	convention	manner
凹处	pocket
翅膀	wing
[机]轴承	bearing
污染（作用）	pollution
=mathematics（英）	maths
不常有的乐趣（或享受、优势）	luxury
破折号	dash
计划	design	enterprise	plan	programme	project	scheme
丛林音乐	jungle
逃走	escape
星形轮	spider
内脏	gut	inside	internal	inward
门口	entry	doorway
修士	religious
社会渣滓	trash
美铝	aluminum
犯罪团伙	mob
弓	bow
（尤指用作容器的）圆筒状物	cylinder
头部	head	poll
贡品	tribute
风铃	mobile
伤心事	sorrow
口可怕的事情	nightmare
[集合词]飞机	aviation
沸腾	boil
个体	unit	individual
产生	generation
迟钝	inertia
夫人	madame	wife
口少量	ounce
进口商品	import
白昼	daylight
书脊	spine
触发电器	trigger
（木制）长凳	bench
法（用于已婚妇女姓名前的尊称）太太	madame
额外令人高兴的事情	bonus
变乱	disturbance
信奉	embrace
中国式平底帆船	junk
科目	course	subject
Eternal上帝	eternal
缺口	breach	chip	gap
机构	apparatus	framework	organ	organization	agency
处方药	prescription
警卫	guard
汤	soup
乐曲	music
廉价出售的图书	remainder
直觉	antenna	insight	intuition
安全设备	safety
拉链	zip
十八岁	eighteen
多数	majority
牧师	minister	priest	shepherd	divine
[法]履行（契约等）	implement
投票数	poll	vote
八十	eighty
（尤指卧铺车厢的）列车服务员	porter
遵守	obedience
接力赛	relay
年刊	annual
适当人选	material
饶恕	pardon
温室	greenhouse
名词	noun
鞋底	sole
护罩	shield
年利	yearly
[复数]房屋	premise
揭发	revelation	exposure
女主角	heroine
数目	discount	number	quantity
测量图	survey
旁观者	spectator
前厅	hall
运载工具	mount
出租马车	cab
隐约的闪现	glimpse
咧嘴笑	grin
信	belief	letter
组件	module
湿气	moisture	sweat
医疗设备	doctor
[建]圆屋顶	bell
下场	grave
熟练	proficiency	skill
新发明	innovation
警官	officer
蒜头	garlic
确信	conviction	assurance
牺牲行为	sacrifice
（人或车辆）行列	queue
量级	magnitude
纸张尺寸	imperial
伪造的货币	queer
成份	score
反驳的回答	retort
小卖部	canteen
[体]篮球运动	basketball
宴会	banquet	dinner	feast	symposium
资助人	patron
混合（状态）	mixture
起始点	verge
通讯中用以代表字母u的词	uniform
补片	patch
钢制品	steel
[化]镍	nickel
电话转接员	central
厌恶	disgust
秋千	swing
卷轴	reel
化学作用（现象）	chemistry
方格	square
上坡	up
获得	acquisition
增值网	van
蛋糕	trifle	cake
主旨	motive
公用电话亭	booth
成熟雄鸟	cock
大多数	bulk
表达	expression
委任状	commission
储备物资	provision
现今	today
女士	madame	miss
码头	dock
括弧	bracket
砏岩	scar
性能	capacity	performance
眩晕	spin
地下室	basement	cellar
（可听到响声的）重击	crack
[乐]弓根	nut
霜冻	frost
汹涌的行动（或思想）态势	wave
（书）写	writing
“dialogue”的变体	dialog
依据	warrant
邮资	postage
[机]平面锤	flatter
脊柱	spine
烟雾污染	smog
烧蚀	erosion
战士	champion
简短声明	brief
扑灭	destruction
谷地	valley
进入	entrance	entry	access	income
巴士	bus
一万亿	billion
矮子	dwarf
发明物	invention
人才	talent
葡萄	grape
地面	floor	ground
奖赏	premium	prize
或然性	probability
情况	case	condition	state	instance
病人	patient	sick	invalid
[乐]主题	theme
上将	general
直达的火车或汽车	limited
凝固	set
联合集团	combine
谜一般的事物	puzzle
阻碍物	hamper	interference
多样化	variety
背信	treason
同盟盟友	federal
条纹	stripe
最重要的优越性	best
奴隶般受控的人	slave
中止	halt
条约	compact	pact	treaty
行距	leading
形成物	formation
女儿	daughter
（语法）人称	person
（气温	dive
证书	deed	letter
美口可口可乐	coke
复制人（或动植物）	clone
锻铁炉	forge
夸张的行动或形象	production
贡献	contribution
更易	shift
来源	fountain
[航天]宇宙飞船	spacecraft
（象征胜利的）棕榈叶	palm
野战医院	ambulance
谷物粗粉（用作饲料或加工面粉）	meal
白色颜料	white
歌剧	opera
启发灵感的人（或事物）	inspiration
触轮	trolley
[主英国、新西兰口语]宴会	do
[部门	steward
围城（期间）	siege
额外的时间	overtime
球茎	bulb
富人	wealthy
空闲时间	leisure
原稿截止时间	deadline
粮食	cereal	food	grain	supply
牲口	animal	cattle
渔民	fisherman
家里人	household
生细胞	cell
胚芽	germ
发热	fever	flush	heat
[乐]组曲	suite
颤动	tremble
发烧	fever
会客室	chamber
惊恐	scare	startle	alarm
宽慰	relief
被压碎的状态	crush
画风	pencil
烟叶	tobacco
外面	outside	outward	exterior	external
支持者	support	advocate	ally
不定期领取救济金的人	casual
退出	exit
美俚囚犯工作席	piano
嫉妒	envy
史殖民	plantation
（潜艇）下潜	dive
地位较高的	senior
有关系的事	funeral
游客	visitor
不光彩	disgrace
大城市人	metropolitan
苹果属植物的果实（如野生酸苹果、沙果）	apple
线索	clue	cue	hint	key	thread
审判员	justice
地图	map
侵犯人身	assault
电梯	elevator	lift
纸上空论	academic
几率	odds	probability
露岩	scar
转向	turnover
聊天	chin
寻常的事物	commonplace
奖状	diploma
（球等的）反跳	bound
航线	route	airline
伙计	guy	assistant
（需要技术、工艺的）行业	art
评判委员会	jury
一瓶（的量）	bottle
公文夹	jacket
精力	energy	go	kick	steam	tuck	zip
组成	constitution
陷入	plunge
启示	message	revelation
被发现的事物	discovery
大笑	laughter	roar
[影视]歌舞片	musical
不断袭击	siege
试图	crack	offer
滑屐	slipper
热烈鼓掌	applause
支持	behalf
开动	start
英镑	pound
入选者	choice
[天]黄经	longitude
[语]大括号	brace
爆裂	burst
未开化的地方	wild
刺激物	prompt
制成品	manufacture
十字架	cross
记日志者	journalist
触点	contact
断崖	scar
舞曲	dance
替代者	replacement
推开	shove
披肩	cape	wrap
东方国家	east
关键	hinge	key
突发事件	emergency
拇指球	ball
多余量	excess
压榨	press	squeeze
黄油状的食品	butter
内衣	shirt	vest
神经	nerve
（赛马的）开始	off
闪烁	glitter	wink
历法	calendar
成就	effort	success
可能入选者	probable
信望	prestige
北部	north
警戒状态	alert
化石	fossil
颅骨	skull
恩泽	benefit	grace
[地质学]地核	core
宗耶稣	lamb
大学或其分校	campus
用半径度量的圆形面积	radius
抵触	interference
包装袋	package	packages
颠倒的事物	invert
捷运公司	express
暴虐	violence
痛苦	anguish	cross	hurt	misery	pain	smart	torment	torture
样式	make	paradigm
乳脂	cream
大笔款项	packet
粪便	stool
秒	second
锋利	edge
死者	dead
涡轮机	turbine
货柜	container
玻璃	glass
车道	lane
考虑	consideration
秆	stalk
[病]震颤	thrill
种	race
芭蕾舞剧	ballet
秋	autumn
战栗	tremble
侄女	niece
语调	dialect	tone	tune
传送带	belt
相片	photo
男性穿的紧身裤	hose
轴线	axis
哲学体系	philosophy
安全设施	safeguard
苗圃	bed	nursery
上衣	coat
整枝法	training
度	degree	dimension
交通	traffic
主动性	initiative
列举的）项目	particular
]伊斯特尔地貌名称	Easter
咆哮声	roar
驱策力或拉力	locomotive
哨子	whistle
库	shed
副歌	refrain
竞赛等的）全体评审员	jury
看不见的人	invisible
床	bed
炸药	explosive
发光	lightening
扭	screw
足迹	footstep	trail
降低	reduction	slide
好奇	amaze
设备	device	equipment	facility	fitting	plant	provision	furniture
电火花	spark
消化道的下段	gut
安全瓣	safety
需要	demand	need	occasion	request
屈服	stoop	surrender	yield
衰竭	breakdown
（排出的）废气	exhaust
印成的图画	print
[美]奴仆	servant
临时雇员	temporary
优先考虑的事	priority
[火箭]助推器	motor
（一张）复写纸	carbon
平地层	table
贺词	compliment	congratulation
版税	royalty
杂志	journal	magazine	periodical
博士学位	doctorate
探测仪	probe
滥用	abuse
粗糙的部分	rough
人身自由	autonomy
美口入口	in
从句	clause
并存	coincidence
舱板	deck
女长服	gown
〈罕〉进行	procedure
性情	temper	tendency	disposition
意外的灾害	blow
溪谷	valley
主张	opinion	proposition
用法说明	direction
[数]次元	dimension
经营	operation	politics
（工资、薪金的）提升	raise
[商]囤积	corner
预测	estimate
感情的中枢	quick
环形物	ring
扩张物	expansion
相关性	relativity
力大如牛的人	bull
刑罚	penalty	torment
文诌诌	heroic
殖民时代建筑	colonial
超出额	overflow
人造毛	fur
承认或允许	concession
名气	reputation
富有战斗精神的人	militant
布景	set
发言等的）重点	burden
混凝土	concrete
扎	prick
公章	chop
（逻辑学中的）大[小]前提	premise
自相矛盾的人或事	paradox
宣传效用	publicity
路堤	fill
合格者	eligible
鸣禽	chat
压（力）	pressure
复合物	compound
几何形状	geometry
实习班	workshop
服侍	service
食客	parasite
音律	swing
短时间	little
轮胎	tire
耽搁	delay
政策	policy
高处	high
失误	fail	miss	mistake	slip	stumble
[化]臭氧	ozone
（台球等运动）（台球桌内侧边缘的）弹性衬里	cushion
按摩师	rubber
兔子肉	rabbit
关切	favor
闸门	gate
顺从	obedience
否认权	veto
奸情	intrigue
食品商	grocer
月状物	moon
电路	circuit
编号为五十的东西	fifty
产额	produce	yield
日常饮食	diet
[建]门或窗户上面的线脚	label
]伊斯特尔住所名称	Easter
口王室成员	royal
黄色植物染料	weld
美式足球用球	oval
舞台	stage
价值等）暴跌	tumble
围困	siege
足够	enough
住宅	house	residence
思索	thought
（路上的）休息（或进食）	bait
面包	bread
贿赂	bribe
要点	hang	heart	outline	point	sum
帝国领土	empire
制图	drawing
案件	case
声望	prestige	reputation
搁板	shelf
训诫	lesson
目前	now	now
叶柄	stalk
外界	environment
螺母	nut
恐怖	fright	horror	terror
播放时间	broadcast
有才能的	capable
汽车旅馆	motel
贮藏	storage
替换物	alternate
印象	effect	impress	impression
能谱	spectrum
明星	star
（靠近路中央的）外侧	outside
[语]转换	transition
病房	ward
（体育比赛中）胜利	win
消遣（方式）	recreation
泉源	fountain
星期六	Saturday
礼拜天	Sunday
恒心	stability
自治	autonomy
补偿	compensation	offset
小河	fleet	stream
[电影]情怀九月天	September
办公桌	desk
讽刺作品	satire
身高	height	inch
载货量	burden	shipment
侵害	prejudice	invasion
[语音学、韵律学]音量（指元音或音节的长短）	quantity
仪式	ceremony
赢	win
总统	president
模糊不定状态	vague
反复	repetition
雌性植物	female
如下	following
有限的事物	finite
当地产的动（植）物	native
会谈	conversation	interview
（法庭的）开庭	session
哲学思想	philosophy
人们以古希腊罗马的思想文化来繁荣文学艺术）	renaissance
相对物	counterpart
计时器	clock
珍珠光泽	orient
洗衣店	laundry
极盛时	full
恳求	plea	suit
幽暗	dusk
引号	quote
账簿	book
大写字母	capital
徽章	badge
骨质物	bone
作文	composition
含义是“复活节”(Easter)	Easter
珍珠	pearl
窑	stove
话务员	operator
盖住	tuck
[语]次重音	secondary
静止摄影	still
结霜	frost
梦	dream
通信	communication	correspondence
公职	office
研制	develop
（化验的）抽样	specimen
主办人	entrepreneur
（尤指）爱情的俘虏	conquest
水	water
招待会	reception
盖子	cover	lid
繁荣	boom	prosperity	up	wealth	welfare
结合（物）	bond
〈废〉学问	clergy
答辩	plea
梁	beam
包租	charter
掉换	shift
起重机	crane	hoist	lift
浩瀚	vast
查账	audit
[电影]克里斯蒂安	christian
干事	manager	steward
画家	painter
杀戮	blood	murder
守灵	wake
仪器	apparatus	instrument
一团糟	chaos
慈爱	affection
摇篮	cradle
（网球等的）球拍	bat
被流放者	exile
指针	finger
挥霍钱财	waste
原始人	primitive
本领	feat	goods	skill
拥挤	huddle	jam	squeeze
（英格兰、威尔士和北爱尔兰由议员选举产生的）镇长	mayor
地带	region	zone
说明书	specification
参加比赛的人	entry
监视	ward	watch
公尺	metre
贫民窟	slum
〈美俚〉支持政党上台所分到的好处	pork
（学术的）基本原理	grammar
温柔的女性	feminine
发布的新闻[消息]	release
晦暗	opaque
诗行	verse
管理技巧	management
（音乐的）调	key
（音频系统的输出信号在输入端收到时发生的）反馈杂音	feedback
牛肉	beef
鞋带	lace
礼节	ceremony
[牌]放在一边的几张牌	widow
文件夹	file
人面兽心的人	beast
英炸马铃薯片	crisp
学位	degree
语副词	adverb
插头	plug
抛弃	discard
琐事	trifle
（对爱人的昵称。男子用以称呼不相识的女子则有冒犯之嫌）宝贝儿	baby
高背长靠椅	settle
诉讼程序	procedure
识别力	sense
周末	weekend
高级官吏的家属	familiar
奸险的人	snake
活跃	activity
[计算机]光笔指令	gesture
衣领	collar	neck
（参与、得到等的）份	share
论文	article	paper	thesis
盛宴	banquet
阿妈	nurse
今晚	tonight
犹豫	pause
外部情况	external
块	block	lump	mass
坑	hollow
羁绊	bond
玫瑰	rose
不可多得的人才	treasure
有…样的骨头的	bone
大堆	flock
书	book
泉水	spring
九	nine
（动植物等的）分类学	classification
许可证	charter	letter	license	permit	warrant
心力	mind
给予	accordance
妥协（或折中）方案	compromise
害处	penalty
蓝本	prototype
（报刊等的）稿件	copy
雷声	thunder
怀有恶意的人	malignant
目击者	witness
日报	daily	journal
（通常指围起来的）果园	orchard
配对物	counterpart	mate
野鸭	duck
（图画或照片的）强光部份	highlight
精华	essence	flower	goodness	pick	prime
（诗中）节奏的停顿	pause
无用的数据	garbage
（用金属或塑料制作的）容器	can
出家人	religious
镶嵌图案	mosaic
围栏	pen	rail
厨房	kitchen
知情者	in
凤梨	pine
[化]萃取物	abstract
外貌	appearance	exterior
排气装置	exhaust
[医]牵引	extension
捍卫者	champion
增加的人或事物	addition
甜樱桃	merry
过渡期间	interim
董事长	president
最后命运或结局如何已显然可见者	candidate
装修	fitting
释放令	release
毛皮	skin	fur
共和国	commonwealth	republic
钻头	drill
九个	nine
结算单	statement
伤害	harm	hurt	prejudice	wound	injury
联邦政府	federation
从犯	accessory
（用于姓名或姓之前	miss
益处	advantage
礼拜四	Thursday
田埂	ridge
姨母	aunt
受赡养者	dependent
聚居地	colony
（乐器上的）弱音器	mute
摆动	swing
工作台	bench	table
有某种文科知识的人	scholar
大多数人	most
笑料	joke	laugh
正规军	regular
降半音	flat
萧条期	winter
一次吞咽的量	swallow
对手	match	opponent	rival
详述者	amplifier
侦察器	detector
干燥室	stove
所有物	effect	possession
虫爬着似的感觉	creep
喷泉水	fountain
稳定水平	plateau
（公共汽车和列车等的）常规路线	route
[物]极点	pole
粗心大意	nod
水桶	bucket
乳液	milk
〈罕〉（负伤鸟的）笔直向上飞	tower
[机]节速器	governor
（公司等的）董事长	chairman
三个人[东西]	three
起形成作用的人	former
崩溃	breakdown
地雷	mine
处事的能力	management
发票	receipt
领导	cock	guidance	lead	leadership
过错	fault	sin
序言	preface
烟草卷	twist
死亡	death	doom	fate	grave	tomb	exit
智力测验	puzzle
变换	conversion	shift
（某一学科或艺术形式等衰落后的）复兴	renaissance
（印有运动员编号的）运动背心	vest
强烈	intensity
（一年之中的）重大事件（或重要日期）一览表	calendar
法人	corporation
支出	expenditure
创作室	workshop
供装配的零件	assembly
（演出或活动的）程序	programme
角色	character	part	role
（路线或方向的）改变	turn
数倍数	multiple
建筑风格	architecture
传教士	missionary
食用的鸡（等的）腿	thigh
声音信号	audio
过低估价	underestimate
青肿	bruise
幼苗状物	sprout
（事情的）意义	port
桨叶的水平运动	feather
地点	site	spot
口哨	whistle
宇宙空间	void
渎神的言词	oath
税收	duty	revenue
教派	religion
考察	consideration	expedition
[航空学]跑道入口	threshold
财富	bag	means	pocket	wealth	worth	dollar
系统	system
占有物	possession
连锁商店	multiple
纷乱	coil
（金属的）发光的颗粒	spark
海绵	sponge
工装裤	overall
发冷	chill
杂技演员	acrobat
演出	performance
羞辱	shame
窗口	window
某方面	respect	way
尺度	gauge
地租	rent
（弯曲路面或轨道的）外道	outside
口服避孕药	pill
（机器部件等的）锁定	lock
直升机	helicopter
（旅馆的）住宿者	resident
结算	settlement
四十	forty
融洽	harmony
公映的新影片	release
事业心	enterprise
长靴	boot
离婚	divorce
进口货物	foreigner
相似物	analogue	parallel	resemblance	similar
英俚警察	bobby
喂送	feed
庙会	fair
（某种行为、感情等的）理由	cause
心窝	breast
复数	plural
生产率	productivity
可耻的事	sin
星期四	Thursday
翻译	translation
对称	symmetry
拥塞	choke
沉静	silence
毛发织物	hair
提倡者	advocate
古命运女神	weird
差使	embassy
（书、报、杂志等的）一版印刷总数	edition
优胜者	superior
铭文	legend
复写的副本	carbon
呐喊声	slogan
〈美〉（政界的）鸽派人士	dove
[物]张力	tension
（某些学院或大学的）董事	fellow
[天]天箭座	arrow
十年	decade
运河	canal
框架	frame	framework
成见	prejudice
壳层	envelope
洗手间	toilet
口刺激性言行	needle
职责或工作	duty
容量	capacity	content
柄	hand	shaft
斜面	slope	incline
瞬变现象	transient
罪恶之地	hell
季刊	quarterly
等级制度	hierarchy
无音信	silence
最有希望获胜者（尤指马）	favorite
咒逐	curse
保证书	guarantee
胃	stomach
学校范围内	campus
（会议等的）决议	resolve
撞击	bump
天然物质	crude
菖蒲	flag
大象	elephant
呻吟	groan
集团	collective
硫黄	sulfur
拖鞋	slipper
芦苇杆	reed
皇族	purple
全体乘务员	crew
表盘	dial
主管	director
手段	avenue	means	medium	passport	step	tactic	technique	action	implement	instrument
火箭	bird	rocket
（马口铁或其他金属制作的）食品罐头	can
食草动物	vegetarian
[艺]调和	rhythm
一撮	lock	pinch
弥撒升阶圣歌	gradual
非正式责任	pigeon
制动（装置）	arrest
资金偿还	refund
罢工	dispute
黄油	butter
〈美口〉歌唱会	sing
第一	first
（门、窗等的）闩	bar
人类	human	humanity	man	mankind	mortal	people	rational
绝妙的东西	vision
情报	intelligence
谈话	gossip	speech	tell
休息室	lobby
趋势	current	drift	stream	tendency	tide
冰雹	hail
敲门（或窗等）声	knock
结合力	bond
边音	lateral
路	path	road	route	row
珍爱的人	precious
摊位	booth
公式	formula
音槌	hammer
公开	daylight	open	exposure
[宗]教堂	church
病危	death
〈古〉战车	car
道德观	morality
[物]卵形线	oval
模糊不清的事物	blur
文风	language
（某一事物的）全部特征	syndrome
跳	skip
奋起	rouse
步	step
侦察机	scout
女统治者	mistress
大蒜	garlic
门	door	gate
荣誉	credit	glory	honor	merit	palm	reputation	distinction
元件	organ
答应	yes
才能	capacity	faculty	quality	skill	talent	ability
闸	brake
机长	captain
倡议	initiative
药剂	drug	agent
规划图	layout
[数]解析	analysis
反语	irony
极端	extreme
精确	true
土话	jargon
动	act
[纺织业]平针	plain
电导体	conductor
俗事	earth
洗澡水	bath
被下赌注的对象	bet
土语	dialect
（常指有强烈性吸引力的）两人间的关系	chemistry
一天	day
范围	area	boundary	confine	dimension	ground	horizon	horizon	lap	latitude	margin	pale	province	range	reach	realm	spectrum	spectrum	spread	territory	verge	zone	domain
俗人	layman
福利库	warehouse
人们	folk
武艺	feat
字母	letter
保存	conservation	reserve
三次幂	cube
绝顶	height
全部效果	amount
技工	mechanic
皈依者	convert
布	cloth	fabric	material
风俗	manner
（美式足球的）一节	quarter
堕落	pollution
生殖器	private
欢迎辞	greeting
推动变化的力量	dynamic
指定	assignment	destination
中间	mean	medium	middle	midst
唤醒	circuit
盆子	plate
带	band	realm	ribbon
最高统治权	empire
茶点	refreshment
重叠部分	overlap
（对学生等的）预考	preliminary
空心砖	tile
（作为一个单元处理的）作业	job
正午	noon
消费	consumption
（衣服的）肩部	shoulder
录像机	video
（螺丝的）转	screw
（市中）商业区	downtown
停止活动	layoff
激将	dare
工业股票	industrial
遥控器	remote
战争状态	warfare
执业者	practitioner
瓦片	tile
状似三明治的东西	sandwich
姐妹	sister
补给品的发放	log
心爱的事物	religion
夹心面包	sandwich
航天飞机	shuttle
[微]细胞核	nucleus
保留地	reservation
情人	beloved	bully	flame	lover
暴力	violence
取样器	probe
（报刊的）评论	review
向上甩头	toss
运输系统	transport
[法律]异议	exception
前景	outlook	prospect
映像	reflection
夸张	inflation
投票总数	ballot
心情	cheer	cue	feather	humor	mood	tune	affect
机能	mechanism
罐头盒	tin
回	chapter
申请	application
举刀（礼）	salute
亏空	deficit
强光	glare
囊	bag
蛮横的人	bear
冷饮柜	fountain
决心	mind	push	resolution
（电子计算机创造的）通讯、信息空间	cyberspace
杰出人物	worthy
底层	render
活跃的人	active
消失	eclipse	lapse
〈美〉新来移民	pilgrim
浮华少年	blade
频率分布	frequency
必然的事	certainty
绕在卷轴上的线（或金属丝、胶卷等）	reel
十九点钟	nineteen
团	lump	mass	mat
〈美俚〉古柯碱	candy
[印]下角码	inferior
一组	battery	pack
非正式鼠辈	rat
被揭露出来的事物	revelation
电讯	telegraph
[语]语支	dialect
人名科克	coke
人格	personality
（版心外）的空白	margin
面粉	flour
樱桃树	cherry
浸湿性	soak
大学校舍	university
需要量	requirement
栖息处	lie
机场	airport
<数>坐标	coordinate
最活跃或最激烈的部分	thick
拳击手套	glove
公报	bulletin
[航]航向	heading
常识	marble	wisdom
桨叶	blade
乐章	movement
英（大学的）专科	faculty
（画等的）背景	background
全景画	panorama
（鞋带等末端的）金属或塑料包头	tag
政治制度	regime
轻摇	jog
被抓住的人	grab
盘卷之物	coil
傲慢	superiority
手册	handbook	manual	notebook	brochure
影视]户外布景	exterior
统称某人拥有（或训练的）赛马	stable
[生]子代	daughter
许许多多	thousand
休息	rest
船尾	stern
畜舍	stable
（可随风摆动的）悬挂饰物	mobile
（棒球等的）球棒	bat
一桶（的量）	bucket
无线电	radio
[比喻]（考虑、问题的）角度	angle
微型画	miniature
兵蚁	soldier
中队	company
叠架的一层	storey
出路	outcome	outlet
[体]冠军	title
（爱称）宝贝儿	sugar
门童	porter
女王般的人	queen
清洗伤口	toilet
衬套	liner
古代人	ancient
拉丁语	Latin
二十多岁	twenty
踝关节	ankle
羞怯[胆小]的人	mouse
操纵杆	stick
季考	quarterly
可能性	bet	chance	fear	likelihood	odds	possibility	possible	probability
运费	carriage	fare	freight
[矿]救火员	fireman
暴动	riot
马上刺枪比赛	tilt
大灾难	catastrophe
扰嚷	racket
[医]养生法	regime
情绪	cue	emotion	feeling	sentiment
[精神病学]（表露或觉察到的）情绪反应	affect
[动]秧鸡	rail
被寄予希望的人或事物、情况	hope
制度	order	system	institution
末端	bottom	stern
划手	oar
正式辩解	apology
灵感	inspiration
自杀者	suicide
守夜	wake
攀登	climb	scramble
气象	weather
答案	answer	solution
航天员	astronaut
雨衣usuallyplural	waterproof
腹部	belly	stomach	abdomen
合力	resultant
助手	friend	help	second	aid	ally	assistant
刮面刀	razor
选萃	selection
纲领	charter	platform
奇迹	miracle	phenomenon	wonder
英（在河	bathe
会员全体	membership
节理	seam
小房间	cube
格	shelf
兑换（率）	exchange
根	root
最盛期	bloom
（会议的）一回合	round
比较	compare	comparison
大夫	doctor
酒宴	drink
雕刻（术）	sculpture
[主英国口语]诈骗	do
第二份食物	second
不拘束	ease
树	tree
吸烟	smoke
便宜货	bargain	buy	junk	steal	steal
穷人	poor
〈美〉一小时半以上的大场面电视节目	spectacular
病菌	bug
恶意中伤的话	dirt
展览会	fair
交谈	conversation	discourse	talk
航海	voyage
限定继承权	entail
圆柱	column	cylinder
软鞭子	switch
梳棉机	comb
关于个人的简讯	personal
男性	mankind	masculine
拒绝	denial	refusal
令人焦虑的事	anxiety
公园	garden	park
维修服务	service
管弦乐队的全部乐器	orchestra
花费	cost	spend	expenditure
空论	academic
自在	ease
素养	equipment	quality
眼镜框	frame
图书馆	library
可能的选择	whether
大主教	metropolitan
掩饰	blind	cloak	pretext	veil
太空人	astronaut
尽力	endeavor
（债权人）受优先偿还的权利	preference
环境等的）宜人	hospitality
地基	foundation	plot
红宝石	ruby
疆土	domain
粘固粉	cement
水平位置	horizontal
Clayton的昵称）	clay
幸福	welfare
安定	calm
名声	celebrity	esteem	fame	name	odor	reputation
磅	pound
悔流条	bus
胶水	glue
王朝	dynasty
兵营	camp
过分讲究穿戴的人	exquisite
猫熊	panda
诈骗者	shark
独一	one
安宁	rest	welfare
孪生儿之一	twin
（宗教等的）仪式	ritual
负荷	cargo	load
桌毯	carpet
安慰	comfort
磨	grind
星鲨	hound
（大气	region
[数]极小值	minimum
（食物）洋葱	onion
运气	chance	luck	ship
月桂树	bay
（无家可归者或受虐待者的）收容所	shelter
风扇	fan
踵	heel
平平的来由	complaint
讲演	delivery
[体]高尔夫球棒的尖端	toe
脚脖子	ankle
（小孩的）围兜	slipper
束	beam	bunch
（尤指人的）颏	chin
竞选运动	campaign
钞票	bill
改装物	conversion
防护衣	vest
有抵抗力的东西	resistant
四的	four
细菌	bug
电子邮件	e-mail
自大	importance
条	bar	item
板	board
农作物	crop
（报纸、杂志的）一份	edition
读数	reading
带刺的植物	thorn
白兰地酒	brandy
目标	destination	goal	mark	object	objective	target
安琪儿	angel
[信]接线员	operator
俗话	bat
十四的记号	fourteen
着重	emphasis
图样	drawing
（洗地毯、家具罩套、汽车等的）洗涤剂	shampoo
领子	collar
股份	stake	stock
松饼（食用时常佐以肉汁）	biscuit
烈度	intensity
[建]门侧	reveal
政治学	politics
礼拜日	Sunday
富国	have
[军]现役兵额	effective
十一月	November
线条	line
雀麦	cheat
幽默	humor
小孩子的）背心	waist
综合性中学	comprehensive
航行（学）	navigation
卷宗	file
密谋	intrigue
雌雄成对的动物	pair
座谈会	symposium
对立或相反的事物	contrary
纸条	slip
家庭作业	homework
陌生人	foreigner	stranger
〈英〉一次挤奶量	meal
（非正式）舞会	hop
三岁	three
厨子	cook
银币	silver
叙述手法	narrative
罗网	net
激动	boot	emotion	flame	stir	warmth	excitement
豪华	luxury
雇用	employment	engagement
英飓风式战斗驱逐机	hurricane
（大）家庭（包括父母子女及近亲）	family
跺脚	stamp
列兵	private
意外事件	accident
嗜好者	lover
弱化音	vanish
彻底改变	revolution
高压贮罐	bomb
残余物	scrap
加法	add
口绝境	hole
发动机	engine	motor
性格	character	kidney	make	mould	strain	temperament	disposition
（通常供吟唱的）叙事诗	lay
标准	gauge	grade	norm	normal	standard
官僚主义	bureaucracy
凭直觉感知的知识	intuition
成功所带来的好处	spoil
新闻记者	journalist
汹涌	surge	swell
（南半球的）发展中国家	south
运动员	athlete	sportsman
货运	freight
（尤用作称呼）爸	pop
放钱的抽屉	till
（热带）丛林	jungle
倾听	listen
八十岁	eighty
侦察队	patrol
录像磁带	video
辅助人员	auxiliary
劳工	labor
半身雕塑像	portrait
仙女	fairy
拘留所	gaol
导火线	signal	fuse
苦工	slave
轻松	ease
歪曲（事实）	violence
英大楼	block
凌辱	insult
线路	circuit	line
溜走	sneak
固体	solid
自愿行动	voluntary
[口语、贬义]脾气暴躁的人	dragon
椭圆运动场（等）	oval
金库	chest
倾向	bias	climate	lean	liability	stream	tendency	vein	disposition
瘫子	cripple
准许进入	admission
广告词句	message
保证金	deposit	earnest
手腕	wrist
模范	paradigm
寓意	moral
第二名	second
一点钟	one
长期的干渴	thirst
刺伤	prick
一束	budget
步骤	procedure	step
〈俚语〉女人	broad
行使否决权	veto
品德高尚的行为	morality
鸭肉	duck
法学	law
铃声	bell	ring
朝代	dynasty
行业	business	trade
容忍	tolerance
（热带地区的）雨季	rain
路肩	shoulder
轻微的斜视	cast
学时	period
乙醇	alcohol
〈古〉相对者	moral
找头	change
独唱（曲）	solo
（其他植物所生的绒毛状的）棉状物	cotton
限制因素	parameter
十四天	fortnight
<俚>精神病学家	shrink
（收件人的）称呼和地址	address
海岸	coast
抢劫	spoil
（计算机的）指令表	repertoire
悲剧	tragedy
包含的能力	comprehension
杂耍	variety
袖子	sleeve
十三个	thirteen
荒废	rust
（陆军的）工兵	engineer
观察报告	observation
彩色铅笔	pencil
日历	calendar
小团	pat
誓约	oath	plight
曲线图	graph
客舱	cabin
摘录	extract	excerpt
全胜	sweep
机密	secret
信誉	credit	reputation
独立国	sovereign
一罐	pot
塔兰特	talent
空运	air
破烂物	junk
呻吟声	moan
平方	square
陆军	army
精神病治疗法	psychiatry
[口]大量	acre
先辈	parent
病号	patient	invalid
雪崩	snowstorm
党派	circle	party
房间里所有的人	room
[机械学]夹头	dog
女孩	girl
（对上帝的）赞颂	glory
很小的数量	snatch
早期	childhood	morning
一桶的量	pail
考察队	expedition
冒险家	sportsman
邪恶的力量、势力或化身	evil
诗墓穴	cell
掌权者	in
邮政（制度）	mail
葬礼	funeral
巡逻队	patrol
厚的覆盖层	blanket
小块	knob	pat	tablet
才智	wit
恶言	abuse
开花期	bloom
大人物们	great
一阵狂风	flaw
尸体	body	dust
（支撑用的）直柱	upright
（花草的）茎	stem
某种程度	somewhat
非正式、侮辱植物人	cabbage
神	infinite
熊	bear
[计算机]保存	integrity
标示	indication
应急措施	fix
堆积	heap
圆形	round
视力	daylight	eye	eyesight	sight	vision
[物]性能	efficiency
容貌	brow	feature	person
植物的藤蔓	bind
海角	cape
引诱	temptation	invitation
依靠	reliance
绒头	pile
大海	ocean
基础设施	infrastructure
脏东西	garbage
很少数	few
行人	passenger	pedestrian
源头	fountain	source
经度	longitude
（车辆等）疾驰的声音	zoom
一碗东西	bowl
冒险活动	adventure
薄暮	sunset
劝告	caution	advice
抑制	curb	repression	restraint
放猎狗的猎人	slipper
恭敬	respect
画面	visual
介绍	introduction
美女	lovely
打猎	chase	hunt
削减	cut
美好	beauty
（筑有围墙的）院子	compound
有功效的东西	medicine
保持	maintenance	keep
集市	fair
兴起	rise
关注	concentration
长	length
研究	research	study
抱怨	complaint
最佳效果	optimum
伸展	stretch	extension
剪刀	scissors
青蛙	frog
脚趾	toe
射程	range
大学评议会	senate
熔铁炉	forge
毁灭	destruction	overturn	ruin	wreck
一分钱的硬币	cent
桃红色	peach
不协调	clash
补助金	grant
政治活动	politics
助动词	auxiliary
[摄]反差	contrast
国家（尤指濒海国家）	shore
话题	subject	talk	theme	topic
失窃	theft
塑像	sculpture	statue
宣传	propaganda	publicity
〈美俚〉爵士音乐风格	jazz
介入	interference
稳固	stability
文艺复兴	renaissance
私立学校	academy
（精神创伤的）医治者	physician
常骂人的人	scold
穷困	misery
〈诗〉东风	east
母猪	sow
（地位、实力等）相同的人	equal
疾病	vice	affection	disease
墙帽	cope
补品	cordial
冷嘲	irony
燕尾服	tail
高水平	high
非谓语动词	verbal
消耗（量）	waste
山羊	goat
绅士	gentleman
侦察员	scout
膝毯	wrap
女祖先	grandmother
[解]（筋	origin
[军]空中掩护幕	umbrella
重任	embassy	weight
内幕	inside
授权	qualification
〈美〉恳亲会	sociable
凉爽	cool
加时赛	overtime
声明	declaration	statement	testimony
专心	concentration
膏药	plaster
记录者	recorder
风浪区	fetch
免费邮寄的信件	frank
通用	currency
[建]大梁	summer
精英	elite	cream
宣传运动	propaganda
学前班	kindergarten
感伤	sentiment
狱吏	guard
背井离乡者	exile
含酒精饮料	liquor
提炼物	extract
学习	study
（成功的）举动	stroke
重大	magnitude
弊病	cancer
发生率	incidence
抵消	offset
小人	insect
全盛时期	prime	summer
〈英〉（围盖膝的）围毯	rug
世界	globe	world
要害	quick
兵火	warfare
区别	distinction
突如其来的念头	impulse
[May]五月	may
帆桁	yard
合成剂	synthetic
铅版	stereotype
体力	beef	main
碳酸钠	soda
火花	spark
浮华而不实的行为	jazz
时尚	fashion	mode	style	trend
快门	shutter
甲胄	harness
[商]手续费	percentage
替换	shift
（指方法）录像	video
车毯	rug
主旋律	theme
坦克	tank
大老鼠	rat
姿态	pose
等比中数	mean
列队行进	procession
国籍	nationality
优胜杯	cup
介绍人	reference
过去	past
焊接点	weld
人人谈论的话题	fable
关税表	tariff
恭金	tribute
习惯法	customary
（酒的）标准酒精度	proof
[医]药的用法说明	signature
接缝	seam
坚果果仁	nut
刹车	brake
行头	wardrobe
修面	scrape	shave
（尤指可怕事物的）记忆	ghost
吵闹	bother	racket	row	uproar
幼稚的人	child	baby
平日	weekday
厚颜	cheek
小火车站	halt
排出	exhaust
分钟	minute
（服务的）对象	target
紫（红）衣	purple
触须	antenna
值得努力争取的东西	prize
掌劈	chop
（乘车或骑车的）短途旅程	ride
心得	acquaintance
强夺	rape
细阅	scrutiny
[机]套筒	sleeve
条件	condition	opportunity	qualification
风尚	mode
现实性	reality	truth
主要产品	staple
领导者	priest
价格	price	value
玩笑话	wit
最后阶段	finish
代币	token
演说	speech	tongue	address
时刻	hour	moment
立体图形	solid
气愤	indignation
软设备	software
肚子	belly
（文件等）精神	spirit
同志	brother	comrade	associate
所有权	ownership	possession	property
存在	being	existence
硬币	coin
诺言	word
观众	audience	spectator
必要（性）	necessity
〈口〉战争狂	rage
计算	arithmetic	compute	count	score
骚动	riot	uproar
虚伪	hypocrisy
（受人咨询的）顾问	consultant
有…迷[瘾]的人	hound
今天	today
前途	future
生涯	career
〈英〉可供呼吸新鲜空气的地方	lung
大量	billion	bucket	bulk	flock	heap	lump	mass	mountain	multitude	plenty	sea	size	store	ton	twenty	volume	wealth	abundance
辅助物	assistant
奶妈	nurse
公文	diploma	document
卧室	chamber
全体	all
暂停	halt	interrupt
胡须	beard
[化]淀帚	policeman
脸颊	cheek
书写体铅字	script
古光辉	bright
文笔	pen
（打、击等的）一下	stroke
天气	weather
烟斗柄	stem
征兆	symptom
俯冲	dive
幅度	spectrum
电话总局	central
症状	symptom
崇拜者	following
完美	beauty	finish	perfection
<生>基因	gene
乡村	countryside	village
实在	real	reality	existence
复制品	copy	duplicate	repetition
[数]误差	error
广场	square
歉意	excuse
挂念	anxiety
回顾	retrospect	review
银行	bank
无用的东西	blank
先生	gentleman	sir	teacher
祈祷文	prayer
（能唱的）短诗	lay
隆起	heave
小径	trail
真空管	valve
愿意	will
继续存在	existence
[古]名誉	rumor
〈俚〉爱人	flame
要人身份	status
三月	March
炮弹	shell
草料	feed
预赛	preliminary
钱包	bag	purse	wallet
鹰状标志	eagle
（某些植物的）嫩枝	spear
断言	claim
油炸食物	fry
物相对论	relativity
临时演员	extra
隐私	privacy
先锋	van
特指谎言	invention
站台	platform
三倍的数[量]	triple
（自行车或摩托车的）车叉子	fork
与某处邻近的地区	neighborhood
十字叉	spider
天赋	genius	gift
胜算	odds
运输船（机）	transport
决定性时刻	crisis
极度	pink
天资	gift	talent	instinct
消遣	entertainment	pastime	diversion
烈性酒	liquor
操纵绳	wire
铁钩	hook
（尤指足球比赛的）胜利	result
矿井	mine
[总称]（经常性的）顾客	custom
（衣服的）配饰	accessory
请柬	invitation
粉扑	puff
尤指红光	glow
称标记	label
石首鱼	drum
喷嚏	sneeze
掌掴声	slap
努力争取	bid
对法国人的蔑称	frog
势能	potential
道德标准	principle
行进	march
哼唱的动作	hum
书志学	bibliography
一对男女	pair
放牧人	herd
金融	finance
慈善机关	charity
（议会的）议事程序	procedure
交易情况	market
猛然震动	jar
（电路的）端子	terminal
硫磺	sulfur
大洋	profound
上下文	context
排水口	outlet
告别辞	farewell
海盗船	pirate
经济	economics	economy
鞋舌	tongue
寝具	clothes
色泽	tone
交叉	intersection
细看	scrutiny
层次	hierarchy	layer
羽毛未丰的鸟	juvenile
狐等的）侵入	raid
可感觉到的东西	sensible
速食食品	instant
想	think
个性	personality
毯状物	blanket
扣子	button
鬼鬼祟祟的人	sneak
抱紧	squeeze
柄状物	handle
有用	help
两个东西	two
求教者	consultant
口夜礼服	formal
试穿	fitting
愚钝	density
武器	arm	weapon
[法律]和解协议	accord
类似灌木的东西（尤指浓密的毛发或皮毛）	bush
蹄铁	shoe
俚解雇	axe
（作钓饵的）苍蝇	fly
[医]引流	drain
[虫]工蜂	worker
收入	means	proceed	receipt	income
隔间（尤指火车车厢中的）	compartment
罩衫	overall	wrap
周刊	weekly
椅子	chair
责任）的人	exempt
内存	memory
诗视力	light
（劳动）定额	norm
旅程行期	journey
历史学	history
自我	ego	me
颈	neck
通告	circular
重力	gravity	stress
公共用地	common
色拉	salad
原文	original	text
涂料	paint
妥善处理	satisfaction
富裕的人	affluent
美有拘捕狂的警察	savage
金盘	pan
保护	conservation	safeguard	security
风琴	organ
果酒	wine
国会	congress	parliament
刻纹	sculpture
澡盆	bath	tub
见鬼	hell
（队员等的）进攻	attack
手提皮包	bag
期货	future
（图案式）有形诗	concrete
笔误	mistake
搬运器	carrier
浪漫史	romance
牲口棚	barn
乳霜	cream
付款期限	prompt
银色	silver
数以十亿计	billion
〈美俚〉建议	steer
手书	handwriting
排水	drain
发情	heat
容器（箱	case
（一）卷	coil
生活者	liver
（尤指由政府或雇主给予的）特许权	concession
中间人	intermediate
[数学]正量	plus
〈俚〉优美的体型	build
野兔	rabbit
俚眼睛	daylight
信息包	packet
卫星	moon	satellite	secondary
死亡方式	death
窥视	peep
农学	agriculture
加号	plus
[化学]反应式	equation
淡黄褐色	biscuit
汁	extract
[数]顶垂线	altitude
（钢等）回火	temper
（树木或木材上的）节疤	knot
美百元钞票	century
夹片	fish
工作室	studio
（文体等的）缺点	vice
环节	segment
亲属	relative
注意力	attention
可卡因	candy
平等	equality
精神	energy	mercury	mind	soul	spirit
限量	limit
淋浴器	shower
（土地	revenue
[计算机]捕捉	capture
（或生或熟	salad
洞穴	cave	hole
骨折	fracture
崽	young
护航舰	escort
金币	gold
瞪视	stare
货车	truck
窃听器	bug
江	river
情侣	lover
出租车	cab	taxi
大叫着说	shout
字母系统	alphabet
迅速蔓延的恶劣的或危险的事物	cancer
淋浴	shower
幌子	front
橡皮圈	elastic
媒介物	medium	vehicle
克莱（男子名	clay
途径	avenue	channel	highway	ladder	mechanism	road	route	approach
[医]冲动	impulse
〈口〉裸体	altogether
响声	noisy
（一般）发酵饮料	beer
夸张的行为或手势	flourish
俚少女	bird
美食	luxury
臀围（尺寸）	hip
高级快车	limited
受人利用的人	tool
精良	polish
完成式	perfect
主人	host
堕落的人	degenerate
赢得（物）	conquest
[电]瓦特	watt
忧虑	anxiety	care	fear	harassment	worry
成熟期	autumn
牙龈	gum
（商品等的）展出	exposure
开花植物	flower
机修工	mechanic
（有助于做工或完成某事的）用具	tool
浪子	rip
酥皮点心	puff
<英>大学毕业生	graduate
职位	appointment	place	position	spot
航海图	chart
波动	heave	wave
卷筒	reel
粉底	foundation
贮水池	tank
受托者	assign
联合拒绝购买	boycott
流亡	exile
[语]精确	precision
（口技演员使用的）木偶	doll
百分率	percentage
暴涨	jump
凶恶的人	tiger
快步	pace
钉书钉	staple
前面	front
长度单位	pace
次品	spoil	inferior
经过者	passer-by
对立面	contrast	counter	opposite
碳水化合物	carbohydrate
伤病军人	invalid
弱手	rabbit
全部节目	repertoire
副刊	supplement
告密的人	sneak
兽皮	fell	hide
不另外收费的供应品[服务等]	found
掌掴	slap
免费邮戳或签名	frank
哨房	box
诚恳	warmth
训斥	hell	lecture
偏爱	bias	preference
眨眼	wink
（某种）死法	death
派别	wing
取得	acquisition
空车	empty
接受者	recipient
火箭发射器	rocket
纵列	file
行为	behavior	conduct	deed	path	work	act
蒸汽机	steamer
返乡	return
太阳穴	temple
弥撒曲	mass
采取	assumption
栎树	oak
造反者	rebel
丰度	abundance
（商业）通知	advice
物视点	viewpoint
魄力	courage	force
基金	fund
猜不透的难题	riddle
水平线	horizontal	level
一览	summary
巡回	circuit
猎犬	hound
杠杆	lever
必需品	essential	necessary	necessity	requirement
印刷字体	print
惊讶	surprise
文本	text
一串	bunch	rope
沙洲	sand	shelf
浪漫主义作家[画家等]	romantic
理解力	comprehension
横断	intersection
鱼排	steak
腔调	expression
团队	team
（某物的）顶部	crown
不受公众干扰的状态	privacy
麻烦	bother	difficulty	trouble
难民	refugee
被拒绝或被抛弃的人或事物	reject
平底锅	pan
舔	lick
男教师	master
预约	reservation
缺少量	shortage
钢琴	piano
自尊心	ego
余地	room
反对票	no
战俘	captive
星期日	Sunday
遗迹	monument	remain	remains	remains	ruin
校订	revise
认识	recognition	understanding
群众	crowd	flock
酸味物质	acid
财产	asset	estate	possession	property	wealth	worth
船	ship	vessel
鱼类	fish
今夜	tonight
参加	attendance
权威	authority	muscle	pope	expert
礼拜一	Monday
分配	assignment	divide
交换	change	exchange
脸红或发亮	flush
生活	life	existence	keep
拥抱	caress	embrace	clasp
东南方	southeast
果酱	jam
儿子	son	boy
目录	catalog	list	schedule	table
片刻	minute	moment	space
（拍卖时用的）木槌	hammer
四轮的运货马车	wagon
升降机（美）	elevator
军队	army	military	troop
笔记簿	notebook
开车技术	engineering
仇敌	enemy
[数]相等	equality
上帝	god	goodness	heaven	king	lord
溶液	solution
例行公事	ritual	routine
旧规矩	stereotype
[医学]（军医等的）助手	mate
传言	tale
固定节目	routine
扬谷机	fan
许愿	wish
卓越人物	giant
串	bunch	cluster	string
隧道	tunnel
综合性大学	university
次要	fringe
球形饼干	kiss
临时解雇	layoff
理智	marble	reason
标枪	spear
独家新闻	exclusive
现代	today
电灯泡	bulb
点头	nod
建筑学	architecture
小数	decimal
[建]接合板	fish
骚乱	riot	stir	storm	uproar	disorder	disturbance	incident
明天	tomorrow
分段符号	paragraph
瘦肉	lean
命题	proposition	thesis
早餐食物	breakfast
常客	familiar	regular
未成年	minority
生态学	ecology
请帖	invitation
三个	three
〈英俚〉欺骗	have
大钢琴	grand
执政党	in
胸脯	breast
办公室	office
丑陋的人（东西）	ugly
情景	picture
（短途的）旅行	expedition
移动	remove	shift	travel
冲床	punch
前身	predecessor
胸围	circumference
摇晃	stagger	tremble
喧骚嘈杂的集会	racket
青铜色	bronze
（政府部门的）部	office
措施	cure	measure
非限定动词	verbal
刀片	blade
种植园	plantation
[化]过滤器	filter
遗风	survival
（织物的）质地	fiber
每逢星期日出版的报纸	Sunday
完整	full	integrity
差异	contrast	difference
天鹅绒	velvet
背景资料	background
线缝	seam
热气球	balloon
指示	charge	dictate	direction	prescription	index	indication
斜率	slope
沙果树	crab
星期六和星期日（或略长一点的）休息时间	weekend
历史学家	historian
综合学校	comprehensive
集合鼓	assembly
喷嘴	jet
妨碍议事	obstruction
变异	variation
渡船	ferry
常用于美式俚语	cabbage
篮	basket
柠檬黄	lemon
俚家伙	egg
永恒的事物	eternal
（高脚酒杯的）脚	stem
[力]切力	shear
（德国或奥地利的）总理	chancellor
存在物	existence
原油	crude
[常用复数]专业综合考试	comprehensive
陈列品	display	exhibition
帐篷状物	tent
山楂属植物	may
对照	comparison	contrast
能干的	capable
道贺	compliment
成年的	major
药量	dose
卑贱	simplicity
棉束	flock
车厢	car
回想	mind	recall	retrospect
[法]诉讼手续	instance
纪录片	documentary
寄宿学校	pension
呼声	voice
愤慨	indignation	outrage
窗侧	reveal
空白表格	blank
冒失鬼	devil
侮辱对女性的蔑称	cow
有利的环境	opportunity
小旅馆	inn
恨	hate
夙愿	ambition
支路	bypass
（破产时清算的）分配金	dividend
萌芽	bud	germ
母线	bus
学费	tuition
一对	two
（需要跳越的）障碍	jump
焦点	focus
腐败	pollution
英亩	acre
（政治	advice
难解的问题	why
打瞌睡	nod
垄断	monopoly
参与者	participant	actor
画线者	liner
军旗	standard
咸猪肉	bacon
（动作的）暂停	hang
昆虫	bug	insect
知罪	guilt
突出的边沿	brim
播送	transmission
天线反射器	parasite
机动卡车	lorry
发射	fire	loose	shot	shoot
获益	gain
[数]极限值	extreme
[几]极线	polar
角质	horn
（通常指暂时的）减少	dip
调查问卷	questionnaire
投币口	slit
指纹	latent
窒息	choke
商品	commodity	goods	merchandise
口袋	pocket
蘑菇形物体	mushroom
[语]可能语气	potential
有声名的人	anybody
有生力量	effective
卑鄙小人	creep	rat
大卡	calorie
进入方法	entrance
似长袜之物	stocking
大屠杀	massacre	slaughter
美俚傻瓜	it
（长期的）缺乏	drought
（指头发）拳曲	curl
移走	removal
代言人	spokesman
横切	intersection
眼镜	spectacle
对	couple
鞍形架	saddle
道歉	excuse
肖像画	portrait
受阻	obstruction
喜欢的事物	favorite
敏捷	activity
香客	pilgrim
独特性	characteristic
血管	vessel
贱卖	slaughter
诗一样的作品	poem
储蓄金	saving
论据	argument
暴露	revelation	exposure
信用	credit	faith
宽容	breadth	charity	mercy	tolerance
巫婆	witch
灯塔	lantern
美俚咖啡	mud
气压（或血压）（的缩略形式）	pressure
保姆	nurse
导航	guidance
（机构中的）新成员	recruit
救援	rescue	save
芝麻菜	rocket
殴打	assault	blow	poke
喜剧性	comedy
居住	dwelling	residence
（一件）工作	job
发言	speech
岛	island	isle
最主要的部分	main
复原	recovery
排外者	exclusive
光泽	shine
慰问	sympathy
[数]要素	component
撇	skim
[电工学]并联	multiple
混杂	mixture
内部器官	internal
基础训练	basic
惊叫声	scream
扣状物	button
任期	reign
伟大人物	great
（大学	dean
煤块	coal
岬	cape
计谋	trick
〈古〉私人	private
外国居留者	international
欢乐	sunshine
照料	attention
兴致勃勃	cheer
脓肿	boil
壁炉	chimney	fireplace
（任何面值上的）扣除额	discount
提示	clue	cue	hint	prompt
喷气声	pant
钱袋	pocket	purse
轮缘	rim
真相	fact	truth
荆棘	thorn
总数	sum	total
给弱者增加的杆数（按击球次数计数	handicap
新娘	bride
小牢房	cell
服务业	service
音乐	music
有些人尤其是长者认为这样说比较礼貌）女士	lady
[高]比标准杆少两杆的分数	eagle
掩护	housing
[植]茎	stalk
制动器	brake
杀死	kill
终极	ultimate
绵羊	mutton	sheep
〈方〉地窖	cave
嫌疑	suspicion
调味汁	sauce
[矿业]瓦斯	gas
放大率	diameter
[数学]法线	normal
榨汁机	mill
处方	prescription	recipe
社会恶习	cancer
连衣裙	dress
烧痕	burn
可能	likelihood	possibility
（学习或研究的）领域	field
效能	efficiency
会计人员	accountant
羊肉	mutton
背诵	repetition
探照灯	flood
租约	lease
亚麻线	linen
（感情受到的）伤害	bruise
附律	novel
咀嚼	chew
单锚系泊的船位	sheer
区划	compartment
<语>性某些语言的（阳性、阴性和中性	gender
家庭般的温暖	bosom
漏洞	leak
布道所	mission
有机组织	organism
小仙子	fairy
低声的抱怨	murmur
后嗣	heir
嚷闹	racket
非正式易受骗的人	pigeon
（某些昆虫的）毒刺	sting
笨蛋	dim	donkey	noodle	simple	stiff	stupid	it
（一段）时间	period	while
黄色	yellow
溪	river	stream
最小量	minimum
（烹调的）原料	ingredient
薄纸	tissue
（争议一方的情况或论点）要点摘录	brief
造反	rebellion	revolt
一连串	stream
行程	passage	run
场边的运动员休息区	bench
经过	passage
荒原	barren
偷窃	steal	theft
奇物	curiosity
行军	march
捏造：内心捏造的东西	invention
离题	excursion
居民	people	resident	inhabitant
对未婚女子的称呼）小姐	miss
（尤指旧时讨论特定步骤的）协商会议	council
喷气式飞机	jet
花边垫子	pillow
宗教的狂热	enthusiasm
叶子	leaf
编织法	knit
电影院	cinema	movie
自动手枪	automatic
[剑]闪避	volt
（注册）商标	trademark
（时间的）持续	duration
壁联	respond
家具	furniture	implement
[计]字符	character
足弓	arch
指导者	guide	shepherd
防护措施	safeguard
结晶（体）	crystal
酒馆	pub
天堂	heaven
夫或妻	spouse
架子	shelf
[语]祈使语气	imperative
特价商品	bargain
口考试	exam
本能	principle	instinct
点	dot	point
[乐]装饰音	ornament
日落（时）	sunset
鞍马	horse
[机]回动	reverse
忽略	overlook
医术	medicine
炉	stove
小溪	brook	spring
大企业组织	empire
起泡	bubble
[化]生成物	resultant
客机	bus
一桶之量	barrel
或集团等	autonomy
伤亡（人数）	casualty
煞车	shoe
管理（方式）	conduct
保险装置	safety
分水岭	shed	divide
三分之一	third
延音	glide
喧嚣嘈杂	riot
有趣的事	fun
排	line	row
内心	interior
半面	profile
喇叭	horn	loudspeaker	trumpet
极热的地方	furnace
处境	situation
邮政	mail	post
西部	west
装饰物	ornament
（称志同道合者）姐妹	sister
输送	carriage
（放花盆的）垫盘（等）	saucer
天空	air
小时	hour
沾污	pollution
原型	ancestor	original	prototype
（不尊重的非正式称呼）女人	lady
振奋	excitement
（作某种用途的）场地	field
腐化的人	degenerate
重大事件	era
感激的样子	gratitude
月球	moon
资格	qualification	qualification	requirement	state	ability
一阵	hail
草莓	strawberry
泛滥	flood	fresh	overflow
十元纸币	ten
手术	operation
紫罗兰色	violet
线状物	thread
氮气	nitrogen
（抹在墙上的）底灰	render
汗衫	shirt
无声电影	silent
同情心	bowel	sympathy
[法]证人	witness
行动	deed	proceeding	action
滑行	glide	taxi
弹仓	magazine
永恒值	constant
老人	elderly
酬报	hay
支柱	leg	shore	spur
〈英方〉（山）顶	cop
限定继承的财产	entail
正直	integrity
折磨人的东西	harassment
烤炉	oven
木工	carpenter
晶体管收音机	transistor
影片	film	picture
讲习会	seminar
马刺	spur
无线电收发报机	radio
斑点	patch	spot
电话	phone	telephone
场面	scene	spectacle
心爱的人	beloved	darling
（某些集体聚会游乐的）园地	playground
权杖	staff
身体部位（尤指胳膊或腿）	member
协会	commonwealth	union	association	institute
即兴演奏	voluntary
一副	pair	suite
麻子	pit
海军陆战队士兵	marine
概念	concept	construct	notion
乳品店	dairy
汽缸	cylinder
嚎哭	howl
哲理	philosophy
（委员会的）委员长	chairman
阶级	class	grade
运动家	sportsman
承包人	entrepreneur	farmer
地极	pole
一剂	dose
（补鞋的）掌子	tap
鱼苗	fry
后悔	regret
高位	high	altitude
年岁	winter
（发声或使用声音的）工具	phone
基本原则	basic	basis
景色	outlook	perspective	scene	scenery
麦秆	straw
牧草地	pasture
解除	release
外观	appearance	resemblance	show	surface	exterior	external
[台]球杆	cue
指印	latent
陀螺	top
土木工程	engineering
（实）例	case
柱脚	pillar
遭遇战	encounter
洗熨	laundry
一件文艺作品	piece
颠覆	upset
腹部…形的	belly
折扣	allowance
英雄	hero
公开展示	exhibit
指南	direction	handbook	manual
[数学]支集	support
[计算机]（字符等的）分段	segment
[口语]事件	do
美俚诱拐	snatch
（身体的）衰弱	collapse
工艺流程	process
（热或其他能量的）射线	ray
楼梯的一段	flight
大娘	mother
流传	currency
（意见等的）分裂	rent
律（陪审团的）裁决	finding
军事行为	warfare
口几个	couple
粉笔	chalk
退潮	ebb
门帘	curtain	fly
发泄（情感）的方法	outlet
[比喻]使者	ambassador
疙瘩	knob	tumour
[数]中数	medium
船舶管理人	husband
进程	course	proceeding
划船	row
法律汇编	digest
领巾	scarf
股价等的）暴跌	dive
粗俗的人	peasant
认真	earnest
左右	something
庄严	majesty	royalty
纸烟	tobacco
（文字）陈述	statement
厚脸皮	assurance
耕地	plough	acre
足球点球	penalty
孔	hole
大叫	shout
头脑	head	mind
专业	profession	speciality
赢得的钱	velvet
双骰子游戏	hazard
（乌贼分泌的）墨液	ink
（高尔夫球）球棒	driver
对应	correspondence
高烧	temperature
检验	proof
季	season
十三岁	thirteen
折磨	plague	torment	torture
实际	fact
登记薄	register
时区	zone
涵义	value
无限	infinite
鞭状物	whip
（事件等的）进行	race
曲调	melody	tune
无礼而放肆的行为	cheek
俚笔迹	paw
吹奏（声）	blow
积分	integral
整形	plastic
管束	vessel
剪裁	cut
关怀	attention
[逻]中名辞	medium
商业冒险	venture
正当理由	warrant
节	knot	link	section
商业	business	commerce
光荣	glory	honor
不能兑现的报酬	carrot
严厉的话	snap
一看	glimpse
花	blossom	flower
胆小鬼	chicken	coward	sheep
宣称者	professor
芽	bud
外甥女	niece
头盔	helmet
生活津贴	pension
风趣	salt
半圆形的小馅饼	turnover
记号	mark	sign	symbol	token
（船只、桥梁等上的）巨缆	cable
（电子）计算机	computer
音响	audio
帮派	gang
（啤酒等饮料的）半品脱	half
同僚	colleague
法精华	elite
堡宅	peel
（国家的）岁入	revenue
[常与my	all
危难	distress
一般的高等教育	academy
致意	compliment
加班费	overtime
摇摆	sway	swing
日间	daytime
卑劣的人	hound	snake
赞成	approval	acceptance
盘状的器皿	pan
食品	food
能手	artist	expert
（尤指不利的、有罪的）判决	doom
强盗	pirate
终结	ending
盥洗室	bathroom	closet	lavatory
诨名	nickname
急性肺炎	pneumonia
协商	counsel	treaty
偏爱的事物	preference
鸭子	duck
是八点钟	eighteen
觉醒	rouse
浓度	concentration
便携式电脑	laptop
生日	birthday
用作某种用途的布	cloth
滞后	lag
新采用的东西	introduction
拌色拉的青菜（尤指生菜）	salad
[宗]应答圣歌	reproach
面积	area	proportion
叛徒	traitor
唾沫	spit
环球金融同业电讯会	swift
（一杯）咖啡	coffee
事物	thing
[古语]急行的人	poster
傀儡	puppet
（脚的）轻快移动	twinkle
熏猪肉	bacon
小块地毯	rug
自主	freedom	independence
节期	festival
预定计划	schedule
点滴（的信息等）	drip
地壳	crust
圣徒	saint
梦想	dream
盾形奖牌	shield
理解	comprehension	grip	knowledge
卡路里	calorie
〈口〉尼龙长袜	nylon
（硬币的）公差	remedy
宇航员	astronaut
脱离常轨的人	deviate
放弃	surrender
耕作	plough
革出教门	ban
父亲	father
西部小说	western
良心	conscience
《鲁滨逊漂流记》中鲁滨逊的仆人	Friday
条款	article	clause	provision	term	item
水平仪	level
碑	tablet
好人	good
树皮	bark
土豆块茎	potato
[数]线图	diagram
困难	difficulty	rub	trial
门路	contact	in
芦苇	reed
复杂	complex
无秩序地累积	dump
顺序	rank	sequence	train
优先取舍权	refusal
穗	ear	fringe
摩擦的动作	rub
握紧	clasp
时代	cycle	date	era	generation	time	age
利益	avail	behalf	benefit	good	take	interest
（牲畜的）成批屠宰	massacre
前奏	preface
残疾	cripple
[建筑学]视图	view
容纳者	recipient
[机械学]（金属）衬套	bush
涂底	couch
货摊	stall
（公共汽车、火车等的）司机室	cab
希望的事	wish
漏出物	leak
穴	hole
全体船员	crew
咀嚼物	chew
女表演者	actress
动机	motion	motive	signal	cause	incentive
诱因	incentive
狭条	list
[医]宫内避孕环	loop
清单	bill	list	schedule
〈俚〉警察	cop
愤懑	anger
（液体等的）一滩	pool
降落伞	parachute
治疗法	remedy
〈古〉袋	mail
悔恨	regret	sorrow
楔形物	wedge
大气	atmosphere
打赌	bet
[数]式	expression
联邦	commonwealth	federation	federation
短跑	dash
责骂	lash	reproach
自夸的话	boast
成语	bat	phrase
美德	desert	virtue
短路	short
（电台或电视播放的）广告	commercial
（大）体积	bulk
功效	efficiency
冲动	urge	instinct
（表链等的）小装饰品	charm
奇想	notion
鬼	ghost	shadow
谨慎	caution
一车之量	cart
月经	monthly
基准	basis
人物	character	personality
庄家	crop	dealer
知识	learning	science	understanding	wisdom	acquaintance	information
抓取装置	grab
说服（力）	persuasion
废料	scrap	waste
猿	monkey
投票选举	poll
[语法学]代用词	substitute
猴	monkey
数据	information
[动]铺石状构造[密生的齿列等]	pavement
猎	kill
心烦意乱	upset
被捕食的动物	prey
烟	smoke
契约义务	bond
元音	vocal	vowel
显性基因	dominant
喘气(pant的名词复数)	pants
事例	case
（商业广告上用的）短语	slogan
操纵台	console
不利	minus
履历	history	record	resume
诊断时间	surgery
游乐场	playground
滤色镜	filter
任命	appointment	commission
构想	construct
水兵	marine	tar
（在某领域）广受赞誉的人	toast
售货员	salesman
想法	concept	idea	think	thought
跳跃的距离	leap
木制品	wood
令人心酸	anguish
方言	dialect	speech	tongue
公里	kilometre
例子	example	instance
恶事	spite
口小孩	kid
市集	market
被发现的人（尤指有趣、有价值或有用者）	find
象征	badge	metaphor	significant	symbol	token	indication
抽奖	draw
行政区	region	district
作业	task
早饭	breakfast
便条	note
长久	distance
传播	currency
X光照片	X-ray
销路	demand	sale
树干	stock	trunk
非正极度兴奋	kick
浆糊	size
（迫切的）要求（帮助、同情等）恳求	appeal
智谋	resource
铅板印刷	stereotype
补给品发放的日子	log
发誓	swear
光谱相片	spectrum
行政官员	official
一堂课	lesson
承担	assumption
佃户	tenant
[法]废除	defeat
适宜	hospitality
寺	temple
（照片、绘画等的）细部	detail
重音符号（标在字母上）	accent
气氛	atmosphere	feeling	mood	air
尾	tail
尺	ruler
海军	navy
（尤指用拳头）猛击	sock
钉	pin
焦油	tar
带路	leadership
虚构	fiction
撤回	retreat
（公路或铁路的）支线	spur
严肃	gravity
未婚女子	girl	maid	maiden
非凡的人	phenomenon
平面布景	flat
责任感	responsibility
温度	temperature
与会代表	participant
[多用于英国]特殊教堂	peculiar
敬礼	greeting	salute
词干	stem
蓝颜料	blue
温床	nest	nursery	soil
研讨小组	seminar
摧毁	destruction
佣人	domestic	servant
匀称	symmetry
制作	production
预言家	prophet
热忱	enthusiasm
贺宴	festival
[化]汞	mercury
（人或动物的）气质	temperament
（裤子的）前裆开口	fly
气馁	dismay
候鸟	transient	visitor
发电机	generator
兴奋剂	cordial	upper
（地震）级数	magnitude
记叙文	narrative
镶嵌	setting
精神恢复	refreshment
正常化	normalization
隐现	peep
（缝纫机的）滑梭	shuttle
俘虏	captive	prisoner
亲戚	connection	folk	kin	relative
重获	recovery
无价值的人	cattle
（向更高方向）增长	progress
拉丁姆人	Latin
热心	earnest	passion	warmth	zeal
一小部分	fraction
[虫]口鬃	beard
相反的事物	inverse
〈比喻〉污名	brand
狩猎旅行	hunt
易受人摆布的人	sheep
危害物	enemy
批发商店	outlet	warehouse
面纱	veil
诗	poem	poetry	verse
衣物	clothes	wear
浓缩物	concentrate	extract
楼层	floor
教务长	dean	prefect
马戏	circus
（织物的）凸条花纹	rib
飞跃	leap
优等	superiority
[计算机]客户端	client
声调	sound	expression
综合征	syndrome
搜索	scout	search
类似	analogy
骚扰	harassment
手艺	craft
（社交）集会	company
[植]（脉）迹	trace
联络船	tender
纤维物质	fiber
未开化的人	savage
小马	hobby
〈俚〉非常滑稽的人	panic
金属薄片	leaf
（广播或电视上题材或角色相同的）系列节目	series
测度	measure
平版印刷	offset
减轻	relief
采集	collection
财力	purse	resource
左面	left
百科全书	encyclopedia
剩余	over
光彩	blaze
柜台	counter
女巫	witch
内疚	guilt
魔力	charm
开化	civilization
旅行	cruise	journey	tour	travel	voyage
进度	tempo
运动神经	motor
八十年代	eighty
友谊	fellowship	friendship
[印]未排足的行	widow
划分	split
蜂蜜	honey
（装饰用的）花结	knot
认可	okay	permission	recognition	sanction
婚宴	wedding
方法(mean的名词复数)	means
一伙	bunch	tribe
平均	medium
红颜料	red
单词	word
登场	arrival
眼神	light	look
转换	shift	switch
郊游	outing
投掷	fling	launch	shy
议程(agendum的名词复数)	agenda
滔滔不绝	flow
一瞥	blush	glimpse
根株	stool
五金器具	hardware
现实	real	reality	truth
营养学	nutrition
灵巧	facility
器械	apparatus	appliance	implement
秒表	clock
[体]比分	result
有轨电车	trolley
惩罚	payment	penalty	rod
（尤指一套中的）一件	piece
地道	tunnel	underground
文职官员	magistrate
（正式限定的）定量	quota
商人	dealer	merchant
[语]声调	tone
存货清单	inventory
信任状	credential
担保	guarantee	security	assurance
不及格者	fail
背脊	ridge
正面	positive
零售商店	store
耐久（力）	endurance
场合	occasion	when
骑兵	horse
专业人士	professional
[物]力矩	moment
学生	pupil	student
财产目录	inventory
修理	repair
（统称）掌权人物	elite
激光器	laser
畏惧	dread
附属品	accident	furniture
被选的人	elect
汽轮机	turbine
汽车修理站	garage
连接点	connection
豁达的人	philosopher
体育场	stadium
服装	clothing	costume	garment
挂环	frog
筵席	banquet
密室	closet	cupboard
谎言	deceit	lie
踪迹	scent	trace	track
肺	lung
行情	currency	market
决议	decision	vote
官能	sense
雕刻品	sculpture
希望的东西	hope
[医]（正常的）健康状态	tone
大型公共礼堂	garden
激励因素	spur
碎块	shatter	shiver	trash
附近地区	vicinity
随意	random
五十岁	fifty
[宗教]（行善得到的）功德	merit
派系	wing
部分	part	percentage	piece	section	segment	installment
庄重的角色	heavy
厕所	lavatory	toilet	petty
捕获物	capture
积极分子	active
手枪	pistol	rod
一块布	cloth
两三个	couple
雪豹	ounce
一英里赛跑	mile
没有	lack
夹克	jacket
桌巾	scarf
倾泻	pour
骨头	bone
否定词语	negative
编辑程序	editor
反叛	conspiracy
拥有	possession
戏院顶层楼座观众	god
大罐	jug
某一事项	particular
[航海]公海	main
一品脱容器的东西	pint
[微]分离菌	isolate
大批	quantity
下降	decline	descent	fall
富于浪漫气息的人	romantic
度数	degree
（画的）阴暗部分	shade
奢侈品	luxury
九十	ninety
伤处	sore
犯人	criminal	prisoner
护送者	escort
陪同某人参加社交活动的人（尤指男人）	escort
更坏的事物	worse
废墟	ash	remains	ruin
疑难问题	problem
（帽子所表示的）职位	hat
王妃（王族女性成员）	princess
（一对中的）一只	mate
伏特	volt
威望	prestige
持有违禁物	possession
有特定用途的房间[建筑物]	office
评论	comment	criticism	remark
决意	resolve
全体与会者	convention
端	edge	end
裁判员	judge
章	chapter
洪水	flood
〈俚〉钱	stuff
〈美俚〉情报	medicine
颌	jaw
作品	output	product
皱摺	ridge
[数]度	degree
刮痕	scrape
层积	stack
嗜好	appetite	hobby
[美国俚语]未婚妻	future
剩余（物）	remains
额	forehead
不幸的事	misfortune
装载的货物	shipment
（较高的）社会地位	estate
大臣	chancellor	minister
[计算机科学]指令	instruction
联盟	federation	league	union	alliance	ally
无礼	liberty	insult
残废者	invalid
木偶	puppet
语同源词	analogue
仁爱	charity
纸牌的）四点	cater
地平线	horizon
（做某事的）尝试	go
两性之一	sex
墨水	ink
阳光	sun	sunshine
膳宿费	pension
菜等的）配制	preparation
店员	clerk	salesman	assistant
薄雾	mist
图表	chart	diagram	graph
松鼠科动物	squirrel
速记记录文字	shorthand
闲暇	leisure
智力玩具	puzzle
待议诸事项一览表	agenda
行李	baggage
根本	fundamental
自然的事情	natural
科学家	scientist
爪子	paw
牛的叫声	low
身份低的人	small
香气	nose	perfume
幸存者	remnant	survival
横祸	casualty
易变的东西	variable
航天器	spacecraft
周年纪念日	anniversary
天真	simplicity
U形钉	staple
波斯湾	gulf
药剂师	chemist
柔软的部分	soft
荞麦食品	cereal
地面。水面	surface
小包	packet
推测	theory
意志	mind	purpose
（一窝）幼崽	litter
骨灰	ash
（将文件内容）分段	fragment
文学	literature
（经济）拮据	difficulty
香石竹	pink
路程	path	distance
日记	diary	journal
背面	back	rear
（春天开花的）绣线菊属植物	may
拱基等的）对称	respond
皮革制品	leather
拉力	tension
苦境	hell
（观看野生动物的）隐蔽处	hide
五分镍币	nickel
棚屋	hut
值班人员	watch
报复（行动）	reply
意旨	intention
撕咬	worry
含义是“年轻气盛的六月”(youthfulfromthenameofthemonth)	June
变焦	zoom
寡妇	widow
同胎仔	team
小孩子	tiny	youngster
一辆坦克乘员中的一名	tanker
新奇	novelty
遗产	estate	heritage	legacy
瞬间	minute	moment	twinkle	instant
[法]（证据等的）提出	exhibition
压抑	repression
文艺复兴时期	renaissance
一种牌戏	nap
份额	lot
王权	crown	majesty	royalty
缠结	foul
成功的人（或物）	success
优秀的典范	classic
开花时期	blossom
引人发笑的事或人	laugh
造物主	architect	god
〈美〉投标	proposal
举止文雅且有教养的女子	lady
演出服	costume
羊毛	wool
茶水	tea
（牌戏、下棋等中）轮到的顺序	go
回路	loop
县	county
（由政府授予特权的）特权市	city
胃管	swallow
略图（画法）	outline
（足球队员的）运动服	strip
有节奏的跳动（或拍打）	pulse
下午	afternoon
[物理学]临界值	threshold
黄金	gold
三人一组	triangle
房地产	estate
小饭馆	canteen
下一个	next
意向	mind	motion	tendency	affection	disposition	intention
匙状物	spoon
摩擦	friction
珠宝箱	cassette
话语	remark
十年期	decade
齿音	dental
赏金	price	reward
成套用品	kit
〈口〉强烈谴责	slaughter
防御工事	defence
死神	death
倾斜	descent	dip	lean	list	pitch	slope	tilt	incline
佼佼者	best
锉刀	file
矢志的追求	push
大头针	pin
立场	posture	stand	standpoint
市区	district
特大的大写字母	initial
非常美的事物	glory
（因触球获得的）向球门踢球的权利	try
本地新闻	local
圆状物	circle
形容词	adjective
沥青	pitch	tar
毕业论文	thesis
讲读者	reader
震惊	shock	startle
（由国王或女王授予特权	city
工人	worker
东西距离	departure
拍卖	auction	sale
采用的办法	resort
随球	following
成功实现的事	result
怨恨	despite	spite
进化论	evolution
[电子]脉冲	impulse
保护人	nurse	patron	shield
矫正	recovery
配制好的食物	preparation
副修科目	minor
鞭挞	lash
探讨	research
经线	longitude
干草	hay
结合体	coalition
深处	deep	depth
集	set
美共和党的	republican
前驱	van
仇恨或讨厌的对象	hate
无价值的东西	vanity
工事	engineering
有关	concern
（鞋匠用的）擦线蜡	wax
一般	general
边界	border	frontier
奖励	premium
折叶	hinge
行	row
法制	law
（言语、作风、思想等的）重复	echo
职务	appointment	function	hat	spot
红葡萄酒	red	ruby
（古希腊）酒宴	symposium
人多	resort
专车	special
摆脱不了的思想[情感等]	obsession
大树枝	limb
胡萝卜	carrot
聚集	gather
表	table	watch
无线电探测器	radar
鼓声	drum	tuck
互联网	internet
（汽车的）变速器	speed
（一项）事务	transaction
飞船	vessel
禁食期	fast
（古语）闪光	glimpse
游手好闲的人	butterfly
讲授	tuition
微量	atom	breath	hint	ray	suggestion	trace
英勇行为	heroic
主顾	customer
离去	departure
教育学	education
召回	recall
马车	car
预算书	estimate
族长	chief
宾语	object
总的印象	concept
歌唱（艺术）	song
多拌有蛋黄酱	salad
分级	classification
童子军	scout
伪劣品	fraud
（与人）商议者	consultant
有好运的人	fortunate
外交使节所递的国书	credential
预期	expectation
戈尔登	golden
透平机	turbine
投入	plunge	input
口（使蜡外流的）蜡烛心结的烛花	thief
呼吸力	breath
v.派遣	despatch
（巨大成功或胜利的）心满意足	triumph
刺痛	prick	smart	thorn
讨厌的人或事	horror	pest
（马）惊退	shy
太阳耀斑	flare
进餐（时间）	meal
[法]诉讼	action
洞悉	insight
扣押	extent
声音	noise	sound
聚会	company	meeting
一网的捕获量	haul
供应	provision
手提式打字机	portable
环	circle	link	loop	whirl
缆车	tram
[英]大臣	secretary
侦察	scout
忠实	loyalty	truth
[乐]高音部	first
附加	more	addition
批发商	merchant
超高层大楼	skyscraper
法律制裁	justice
信差	messenger
贫民区	slum
教科书	text	textbook
插话	episode
版权	copyright
广播	broadcast
漂浮物	float
总裁	president
优先权	preference	priority
事业	career	enterprise	project	thing	work
矮小的人	small
〈英〉（军官的）紧身军裤	overall
新生婴儿	arrival
（餐馆的）迎宾女招待	hostess
水准	level
访问	visit
紫色	purple
好感	favor
军事家	soldier
雪暴	snowstorm
报应	payment	wage
蔬菜	vegetable
鳎（可食用比目鱼）	sole
低点	low
榜样	lead	mirror	pattern	sample	example
发言人	speaker	spokesman
被拖曳的某物	tow
好意	friendship
[法]（正式）交付	delivery
年轻	youth
跟随	follow	following
公积金	reserve	surplus
不正当行为	disorder
化学家	chemist
哲]范畴	category
工程师	engineer
经销商	dealer
煮沸	boil
欢心	favor
复印件	duplicate
[植物学]管颈	throat
[法]受托人	committee
同等重要的人（或物）	coordinate
“喂”的招呼声或问候声	hello
管理	direction	engineering	management	politics	regime	regulation	administration
（统称）牧师	cloth
剪报	clip
出价	bid	offer
回声	echo
（鸟	cloud
定钱	earnest
水平面	horizontal	level
状况	case	mode	state	status
网球（运动）	tennis
裁缝	tailor
粉末	dust	powder
病症	focus
美裤子	pants
英楼层	storey
泡的行为或过程	steep
影响范围	incidence
次数	frequency
裁判	judgement
十五	fifteen
起程	departure
肿块	bump	growth	lump	tumour
叶状器官	leaflet
固定的形式	stereotype
新奇的事物	novelty
贫穷	need	poverty	want
新闻快报	bulletin
耳朵	ear
[化]元素	element
医学	medicine
洗衣房	laundry
十亿	billion
[物]电位	potential
一代人	generation
虚荣	vanity
凭理智（而非感情）办事的人	intellectual
动物	animal	creature
投掷的距离	throw
机器脚踏车	bus
传动装置	gear	transmission
（桥牌）拍卖玩法	auction
娱乐中心	hall
<旧	talent
[天]星系	galaxy
（箱子）盖	top
咖啡豆	coffee
收获季节	harvest
改正	reform
心胸	mind
轻蔑	contempt	scorn	slight
收集	pickup	collection
销售	sale	sell
桌子	table
（大学的）研究员	fellow
[建]（柱	respond
胶皮管	hose
泡沫状物	foam
起跑	off
口径	bore
价值	attribute	band	merit	price	value	virtue	worth
货币	currency	money
平常的人（或事）	ordinary
一半	half
同时译员	simultaneous
[生]机制	mechanism
生意	business
序上的）先	priority
[计]磁心	core
一千	thousand
防御	defence
合格证书	qualification
前一天的晚上	overnight
咖啡粉	coffee
味	flavor
在同一地方工作或训练的)一批人	stable
摩擦力	friction
[影视]字幕	title
极点	climax
[法律]答辩	reply
凉爽的空气	cool
干旱（时期）	drought
治疗力	therapy
倍受宠爱的人	darling
〈美俚〉尝试	fling
消息	news	information
徘徊	hover
（成员具有平等权利的）团体	republic
围墙	fence
图解	diagram	figure
约会	appointment	date	engagement
（尤指厨房和餐厅之间供传递食物的）两室之间的小窗口	hatch
直线部分	straight
盔状物	helmet
<古>邪教	superstition
修饰	touch
受害者	casualty	prey	victim
乌鸦	crow
当月	instant
（古代护身甲上的）重叠金属片	lame
会员资格	membership
同辈人	contemporary
蝙蝠	bat
伪装	pose	disguise
企业等的）总部	headquarters
一呷之量	sip
识别	recognition
学派	school
言语	language
指挥部	command	headquarters
[交]铁路辙叉	frog
（戏剧的）一场	scene
正式的讨论	discourse
[基督教科学派]信仰疗法术士	practitioner
误解	mistake
壮观	glory	spectacle
轻推	jog
重读	emphasis
古董	antique
囚车	wagon
股票	stock
搬运工人	porter
独占的事物（或范围）	preserve
菜单	menu
参议院（美国、法国、澳大利亚等国家的两个立法机构之一）	senate
笨拙的人	lump
公里（等于kilogram）	kilo
排水系统	drain
胶合剂	cement
近亲	friend
嫌疑犯	suspect
小册子	pamphlet	brochure
[地]逆断层	thrust
悬挂的样子	hang
统治手段	rein
重复者	echo
[植]油菜	rape
风筝	kite
教养	nurture
（某地区的）地质情况	geology
（为身体提供能量的）食物	fuel
类型	breed	category	description	like	nature	species	type
（英）（比赛用）单人双桨小艇	funny
忍耐力	endurance
调查所	survey
国家的经济状况	economics
同辈	cousin	peer
无法摆脱的恐惧	nightmare
视线模糊不清	mist
发起者	sponsor
使人绝望的人（或事物）	despair
（尤指船过后划出的）水流	wash
救援物资	relief
运输	carriage	carry	transport
密码	code
一段	length	piece
自我意识	ego
汽车的灯玻璃	lens
分科	branch
基本原理	basic	ultimate
传记	biography	story
记述	account
老规矩	ritual
碘元素	I
书法	handwriting
长度	length	extent
打气筒	pump
配药学	pharmacy
营养品	nutrition
射手	shot
好天气	fine	shine
[航]钓锚器	fish
[宗]经外传说	tradition
医生	physician	doctor
掌管	charge	hand
所得	revenue
课文	text
代班人	relief
公约	pact	pact	pledge
典型	model
令人厌烦的人[事物]	pain
敷用药	application
[生物学]顶极群落	climax
取舍	alternative
通行费	toll
苏打点心	soda
[机]万维网	web
作者	author	author
哄骗	junk
结婚	marriage
家庭	home	house	household	household
小容器	capsule
挥手	wave
[动]鲸	whale
〈美〉意见听取会	hearing
[商]准备金	reserve
礼物	gift	present	tribute
麻袋	sack
12月	december
有价值的人或物	asset
大腿	thigh
闪光灯下摄成的照片	flash
显著的性质	specific
羔羊肉	lamb
面团	paste
动乱	trouble	disorder	earthquake
[法]委托人	principal
退休金	pension
宗造物主	infinite
吗啡	heroin
试样	coupon
满意	satisfaction
一节	length
怒视	glare
电动车辆	electric
工会	union
（时间、精力的）投入	investment
最厚的部分	thick
开始	beginning	fresh	nucleus	opening	outset	start	threshold
胡闹	hell	nonsense
单调	prose
一元纸[硬]币	dollar
呕吐	heave
（处理、研究事务的）范围	scope
[数]常数	constant
[无线]探测	acquisition
怀疑	challenge	doubt	question	suspicion
渴感	thirst
童贞玛利亚（耶稣之母）	virgin
眼睛中的水晶体	lens
发汗剂	sweater
兽性	animal
改进	improvement
障碍	bar	barrier	handicap
受操纵的事	fix
令人惊奇的人（或事）	miracle
[常用复数][美国、加拿大英语]未婚（或单身）男子（或女子）	single
可怕的东西	fright
袋子	poke
坟墓	grave	tomb
女拥人或女下属	woman
劫夺	raid
提供公开讨论的媒体	forum
磨粉机	mill
白天做家务的女佣	daily
杂货商	grocer
嗓音	voice
聪颖勤奋的学生	scholar
密友	familiar	intimate
暗喻	metaphor
农村	country
与面食、豆类等一起食用的）蔬菜色拉	salad
斗争	strife	tug	war	warfare
拭	wipe
卑鄙的人	reptile	insect
狡猾的人	fox
（女人	waist
（枪）扳机	trigger
比拟	analogy
称赞	applause	praise	tribute
硅元素	silicon
韵律	metre	rhythm
扰乱	harassment
矿车	tram	tub
英饼干	biscuit
年度假期	wake
拳	fist
拉	drag
有…名称的	name
文明人	christian
战略学	strategy
（舰船上的）全体船员	ship
期待	expectation
看护	nurse
猛击	bang	bat	slam
远足	hike	outing	tramp
愧悔	apology
终点	destination	goal	home
美足球	soccer
拖	drag	haul	pull
贬讨人嫌的丑女人	witch
发现	discovery	strike
镜头	lens
探测器	detector
救星	salvation
特定[生物]种群	population
初期	morning	prime	youth
（可食用的动物的）腰子	kidney
命运	destiny	doom	fate	lot	luck	weird
（艺术作品的）主题	motive
铁锤	hammer
爬	pull
美珠宝	jewelry
爪	click
屠杀者	butcher
和谐的调子	melody
记者	correspondent	reporter
游行示威	march
专家评价	expertise
追随	follow
高压脊	ridge
古小屋	lodge
辞去职务	resign
铁锈	rust
方面	aspect	face	phase	side
干才	manager
扣钩	clasp
部	department
甜食	sweet
冒渎	violence
搔痕	scratch
俚推	hoist
大使馆全体成员	embassy
泉	well
郡	county
风格	atmosphere	style
宽松裤	slack
法	law
境界	pale
连队	company
耳屎	wax
分得的财产	portion
（机构等的）全国总部	national
泡	bath	bubble
扣针	pin
泥	mud
教育	education
被免除（义务	exempt
乐趣	fun	luxury	treat
（房间内的）小隔间	stall
泵	pump
粗筛	riddle
高视阔步	stalk
（选举）投票站	booth
[俚语]疯子	crazy
（颜色协调的）配套服装	coordinate
向下倾斜	fall
住房	apartment
硕士	master
弯头	elbow
客厅	living-room	lounge
降雨量	moisture
女演员	girl	actress
一缸子（的量）	mug
过往	past
[theblue(s)][用作单数或复数]布鲁斯（歌曲）（一种伤感的美国黑人民歌）	blue
子孙	offspring	seed
选民	constituent
[古]喧嚷	rumor
引发其他事件的一件事	trigger
快车	express	express
作伴	company
通信量	traffic
歌词	word
一夜的逗留	overnight
侥幸	mercy
天数	destiny
军事训练	drill
扳柄	trigger
上尉	captain
长沙发椅	couch
金属板	plate
匣	container
花圈	wreath
缺少的东西	lack
困苦	hardship	pinch
赞成票	yes
机械呆板的人	robot
碎片	chip	fragment	patch	rag	shatter
两点钟	two
当政期	reign
匾	tablet
牢房	hut	cage
显微镜	microscope
收藏品	collection
人物描写	portrait
铸模	mould
实际情形	reality
枪弹	lead
口例证	cite
毫无价值的东西	straw
文化	civilization	culture
文豪	classic
匙	spoon
淘汰	selection
同代人	contemporary
赞词	praise
纪念章	medal
隔离种群	isolate
披风	cloak
晚霞	sunset
软体	software
[计算机]执行指令	executive
液体贮存器	fountain
拨号盘	dial
管乐器	pipe
含义	meaning	implication
蜘蛛网	web
碎布	rag
诗情	poetry
疑虑	doubt
（狗等的）项圈	collar
天真无邪的人	dove	innocent
放置者	layer
限制	bound	curb	lid	limit	limitation	qualification	qualification	restraint	tie
（肉体的）缺陷	vice
公馆	residence
可塑体	plastic
（酒中的）配料	dose
爱情小说	romance
领地	possession	territory
疖子	boil
生存之道	living
初学者	infant
[音乐]（音调的）谐和	accord
租金	hire	rent
星象（根据人出生时天体的位置而描述的命运）	star
芭蕾舞音乐	ballet
紫罗兰	violet
傻子	dim	noodle	silly
劝说	persuasion
痛苦的根源	torment
毛毯	blanket	carpet
代表大会	congress
胡瓜	cucumber
（获胜的）票数	majority
手巾	towel
开会	session
顶部	roof	top
合适者	eligible
碗状物	bowl
（已经取得学士学位正在攻读高级学位的）研究生	graduate
美汽车	auto
外表	outward	resemblance	surface
暴风雪	storm
怀抱	embrace
复数词	plural
蜂群	swarm
（动、植物的）毛	hair
条项	provision
包边	border
专长	speciality
参谋	staff
[棒]投得过高的球	overthrow
木料	timber	tree
物]粒子	particle
真空	vacuum
餐后的甜点心	sweet
惰性	inertia
剧本	drama
胭脂红	lake
保育虫	nurse
外行	layman	amateur
[军]英起床号	rouse
未成熟的人	bud
数千	thousand
水沟	slot
准备工作	preliminary
赞扬	praise	acclaim
（带抽水马桶的）厕所	bathroom
药片	tablet
上午	morning
（机关枪等的）连续发射声	cough
使人舒服的事物	comfort
专门用语	language
（旧时的）小镇	ham
小修道院院长	prior
犯人穿的横条囚衣	stripe
打字机	typewriter
腐朽	rot
沙漠	desert
亲戚（关系）	relation
绶带	ribbon
等式	equality	equation
（尤指美国的大专院校的）学期	semester
心腹朋友	confident
溢出物	overflow
模糊	dark
并发症状	syndrome
风味	taste
无穷	infinite
[印]着重号	bullet
技术	craft	feat	science	technique
散页印刷品	leaflet
结合物	conjunction
部落	nationality	tribe
黯然失色	eclipse
[医]肺炎	pneumonia
对等物	equivalent
（赛车道旁的）修理加油站	pit
（戏剧	knot
底色	background
[印]指标参见号	fist
坚定	stability
（北非和西亚常见的海枣树的）海枣	date
促进	impetus
斗篷状覆盖物	cope
洒的动作	sprinkle
潮湿	damp	humidity	moisture
正义	justice
一次	dose	once
开枪	shot
绝对	absolute
挥动	sweep	flourish
配偶	couple	partner	partner	spouse
营养物	bread	nurture
叹息	groan
古自然科学家	physicist
夜总会	club
动员令	alarm
联想	suggestion	association
付款	payment
雪茄	cigar
全体数量	total
幼芽	sprout
生活方式（方式）	existence
批评者	critic
[机]动力	power
培根	bacon
蜡状物	wax
场地	compound	yard
聪明的人	brain
统计表	return
钟	bell	clock
倡导者	prophet
关心	concern	consideration	thought
[宗]教派	church
边缘	fringe	frontier	lip	margin	outskirts	skirt	suburb	verge
规定的单向行车道	lane
一跨（的宽度）	stride
[天]行星	planet
喧骚	racket
西北方向	northwest
〈口〉家属	folk
替班	relay
[天]地平纬度	altitude
簇	cluster	mat
农民	farmer	peasant
奴隶	servant	slave
航班	flight
试验性的东西	experimental
节省	spare
违背宗教[道德原则]的恶行	sin
丛林	forest
相	phase
（雷达）（屏面上的）光点	scan
损耗	loss	waste
饥饿	famine	hunger
供应点心的露天设施	garden
雇工	employee	man	servant
[语]强义词	intensive
马厩	stable
有损外观的地方	scar
制造	make	manufacture
（数学）区间	interval
盾	shield
圣歌（尤指美国南部黑人的）	spiritual
噪音	noise
绒毛	down	nap
电影制片厂	studio
（用作称呼）亲爱的	darling
火山	volcano
特别高的东西	skyscraper
〈俚〉新手	rabbit
诽谤的话	mud
讨论会	forum
松鼠	squirrel
咒骂语	oath
估计	estimate
绒毯	carpet
十一	eleven
丧礼	funeral
十三	thirteen
由Palm公司发明的一种PDA上的操作系统	palm
感恩节	Thanksgiving
（游泳或划船的）划	stroke
尘世	life	world
（船或飞机装载的）货物	cargo
国界	confine
重大聚会	function
恩惠	benefit	obligation
归还	replacement
密探	spy
大变动	earthquake
调查	research	search	inquiry
欲望	appetite	desire	hunger	stomach
操纵者	control
套在一起的两匹马	pair
看台	stand
球（体）	sphere
磁铁	magnet
南方	south
代理人	attorney	deputy	factor	secondary	agent
老主顾	patron
（为促进共同目标的实现而自发组织起来的）促进会	committee
高等	altitude
水平（线）	horizon
风度	presence
蔑群众	herd
告密者	grass
落幕	curtain
一盘食物	dish
批	group
内侧	inside
营业额	turnover
一点也不	damn
水土	climate
（口）渴	thirst
收回通告	recall
要说的话	say
挑战	challenge	dare	defy
托	hoist
水暖工	plumber
出纳员	cashier
额外津贴	bonus
阴影	shadow
心理治疗	therapy
手	hand	paw
总经理	executive
自尊	dignity	pride
丝织物	silk
最重要的事情	highlight
墙角石	coin
国家	country	land	nation	nationality	state
护照	passport
征象	signal
所有制	ownership
（轻快的）敲击（声）	rap
（大学）校园	campus
沙发	sofa
声波	sound
燃烧着的木头	brand
预告	notice
东北	northeast
农庄	farm
剃胡子	shave
填满…的量	fill
小错	lapse
空头支票	kite
免税人	exempt
零件	component	part
默想	meditation
恒星与星辰系	universe
眼光	insight
最低限度	minimum
热爱	love
姨父	uncle
（他人的）工具	creature
粉碎	crush
夜点心	supper
[数]运算	operation
菜馆	restaurant
城郊	suburb
〈英〉对座四轮马车	sociable
姓	surname
授课	instruction
涌动	rush
棒糖	rock
明智	wisdom
障碍物（绊脚石	obstacle
泥土	clay	dirt	soil
识别标志	signature
技巧纯熟的人	technician
老虎	tiger
掌状物	palm
四轮大马车	coach
盆地	basin
桃子	peach
担心	sweat	worry
[电]引入	inlet
语法书	grammar
海事	marine
硫磺色	sulfur
质询	inquiry
传单	circular	leaflet
（房间	suite
促进发展者	fertilizer
有大城市气派的人	metropolitan
悲伤的事	grief
布边	list
特征群	syndrome
燃油	oil
钟声	bell	ring
长条	strip
危机	crisis
切口	cut
侍女	maid
靠山	anchor
药商	chemist
钱箱	till
集邮簿	album
废物	lumber	refuse	rip	trash	waste	weed
现代化	modernization	update
（建筑物的）结构（如墙、地面、屋顶）：质地	fabric
美秋天	fall
精通文学	literacy
球形把手	knob
历史	history	story
加	addition
（定期定点举行的）体育活动	fixture
立法机构的一员	whip
曲线状物	curve
净利	net
[语]完成时	perfect
重要事件的前夕	eve
[电学]电缆	cable
试验	essay	test	trial	experiment
生活过程	orbit
独家经营的产品（或项目、设计等）	exclusive
乘骑	ride
线丝	string
头盖骨	skull
力	force
〈口〉一点儿	suspicion
预算拨款	budget
（尤指道路或河流的）拐弯	bend
发起人	author	author
外景（拍摄地）	location
头衔	title
君主的统治	reign
浅滩	shallow
借口	blind	but	cloak	plea	pretext	disguise	excuse
刃部	knife
动物园	zoo
电视	video
（时间的）消逝	elapse
引文	cite
航行	sail
九十岁	ninety
[航]爬高	climb
裤腿	leg
评价	appraisal	esteem	estimate	judgement	opinion
蛋白甜饼	kiss
踝	ankle
地心引力	gravity
（木偶的）牵线	wire
毛巾	towel	wipe
奖品	award
问候	greeting	regard
（牡蛎等的）鳃	beard
微粒	atom	particle
栋梁	beam
周五	Friday
马桶	toilet
职员	clerk
共产主义制度	communism
欢送会	farewell
白天	day	daytime
探测	research
（感情的）强烈程度	intensity
事务	business	transaction	affair
环顾	survey
首长	head	principal
搏斗	combat	contest
〈美〉竞赛	combat
奖学金获得者	scholar
钝的东西	blunt
（不动脑筋）机械行事的人	clone
战术	tactic
西方人	western
[植]压条	layer
议事室	closet
各种细节	detail
青年	prime	youth
诉讼	proceeding	suit
系列	series	spectrum
掷骰	cast
音乐会	concert
形式	form
彩虹	rainbow
政治	politics
接替的人或事物	successor
最初	first
刮擦声	scrape	scratch
墓地	cemetery
斧子	axe
扫帚	broom
记录器	recorder
拥护者	audience	champion	following
通信者	correspondent
（两事件之间的）时间间隔	lag
一股气味	sniff
教室	classroom
推辞	but
圣迹	miracle
没有多少	little
尖头	sharp
戏剧界	theater
逻辑	logic
美小木屋	cabin
教会事物	spiritual
不和	friction
时装领域	fashion
一套外衣	suit
花冠（有时象征胜利）	crown
（公路或铁路的）交叉路口	junction
缺陷	deficiency	fault	handicap	hole
秘密	confidence	mystery	privacy	secret
破诡计	painter
色斑	stain
睡椅	couch
西	west
（价格等）上涨	up
大错	blunder
墩距	span
预言	forecast
驱赶者	driver
测算表	plot
[医]救急疗法	refuge
策士	manager
（足球）高球	chip
刮刀	shave
雌株	female
立绒	velvet
钟的嘀嗒声	tick
[灭亡]的原因	ruin
小装饰品	toy
流感	flu
（地球上划分出的）洋	ocean
业余爱好	hobby
正常	normal
稠密	density
可爱的人	beloved	precious
（由过去类似物发展来的）派生物	descendant
盘	dish
工具	engine	gear	lever	tool	implement	instrument
见解	eyesight	mind	notion	outlook
一匙的量	spoon
构成方式	constitution
日程表	calendar
揭示	reveal
[商]期货交割失期	fail
可能发生的事物	possibility
汇票	draft
磁盘	disc
上司	boss
无言	silence
特许	faculty	freedom	license
（夜总会的）女招待	hostess
夏	summer
绊脚	stumble
蓄水池	reservoir
铁钳	brace
铲子	spade
（印刷或打印的）文字	type
斗志	fight
基调	atmosphere
林荫路	avenue
遇难船的残骸	wreck
拿来	fetch
入口	entrance	threshold	access
效果	effect	impression
金饰品	gold
悲剧理论	tragedy
拓荒者	pioneer
海脊	ridge
罢免	recall
马口铁	tin
小提琴	violin
半球	hemisphere
洋葱（头）	onion
主持会议的主席（的席位或职位）	chair
邪恶	evil
某个人	someone
犁	plough
[军]突击	thrust
膛径	bore
脚踏车	bicycle
业余爱好者	amateur
接吻	caress
（猎狗的）失去嗅迹	fault
跌倒	slip
补丁	mend	patch
（口）打击	bat
古高龄老人	ancient
紧握	grip
选择权	choice	option
租赁权	lease
快乐	delight	joy
西方	west
刺激	stun	urge	excitement	incentive
（机器或系统	crash
品种	chop	quality
火星	spark
香草	herb
军士军阶	stripe
海里	knot
字迹	handwriting
市郊	outskirts
接合	junction	incidence
义务	burden	debt	duty	obligation
（国际象棋的）王	king
占有者	tenant
拙劣演员（尤指表演过火者）	ham
诗歌艺术	poetry
脑子	skull
自恃心	independence
准假	leave
电冰箱	fridge
政客	politician
粉	powder
特工	agent
飞奔	gallop
混合饮料	shake
二月	February
机械作用	mechanism
未定之事	perhaps
应有的权利	due
晌午	noon
（船甲板或飞机底部装货物的）舱口	hatch
（机器等的）运转状态	behavior
鱼尾板	fish
外星人	alien
家伙	bird	devil	fish	guy	thing	boy	chap
（轮廓、图形等的）鲜明	emphasis
鹅	goose
地毯	carpet
古玩	antique	curiosity
叫喊	yell	cry
游廊	porch	stoop
用功	application
（电影院等的）楼厅	balcony
踏板	pedal
扁平物	flap
海洋	ocean	sea
焦炭	coke
承认	recognition	admission
栅栏	barrier	fence	pale
裤子	trousers
地方行政长官	prefect
鹤	crane
韵味	flavor
可惜的事	pity
免职	removal
[体]木球	bowl
鹰	eagle	hawk
撕	tear
河	river
进入方式	entrance
鹿	deer
尘事	earth
润色	touch
一段赛程	leg
心灵	spirit
基督教徒	christian
尤指纸币	cabbage
电线	wire
托词	veil
临时托儿所	nursery
诱惑	bait	temptation	invitation
（女士）卫生巾	napkin
草坪	grass	lawn
辅助装置	assist
长处	strength	virtue
（药	preparation
远方	far
基数	cardinal
[语]阳性	masculine
监控人员	monitor
盗贼等的)一帮	gang
代用	shift
共谋	conspiracy
十二个	dozen	twelve
躲藏处	harbor
物理学	physics
指标	quota
公告	bulletin	declaration	poster
咽喉	throat
〈俚〉机密	wrap
灿烂	dazzle
连续不断	torrent
富有	fortune
柱	pillar	post
黑颜料	black
道德准则	morality
匆忙	haste	hurry	rush
委任	commission
计接口	interface
滚木球戏	bowling
耽迷于…的人	slave
地主	landlord
照看者	tender
原子团	radical
火车头	engine	locomotive
芭蕾舞	ballet
蠕动	creep
地下	underground
一种程序压缩格式	zip
（合金中的）劣等金属	alloy
盘子	plate	tray
（动植物的）刺	spine
意气相投	sympathy
上色	painting
斑马	zebra
犯规	foul
大小	size
震颤	tremble
〈口〉英式足球	soccer
西部电影	western
遮蔽	cover	shelter
向上的斜坡	upgrade
喷雾器	spray
曲子	tune
溅泼的量	splash
全国性报刊	national
译本	translation	version
感觉	antenna	feel	feeling	sensation	sense	impression
血统	blood	breed	descent	strain
可比拟物	comparative
链条	chain
一则	item
少男少女	bud
话筒	microphone
美顾客	trade
实例	instance
独奏（曲）	solo
吸力	suck
养老金	pension
操纵	engineering
（机场等的）等候室	lounge
（成功的）典范	triumph
套	sham
学会决窍	rope
郊外	outskirts
凡人	mortal
棉线	cotton
棉纸	tissue
急流	rapid	torrent
创始者	generator	pioneer
会期	session
痊愈	mend	recovery
反政府的人	rebel
同盟者	alliance	ally
传播媒介	vehicle
肝胆	courage
机关炮	cannon
劈叉	split
净值利润率	profit
媒质	medium
宝石饰物	jewel
征税	levy
二进制	bin
巨头	prince
悲剧文学	tragedy
细菌（复数为bacteria）	bacterium
溢流	flood
工作集体	firm
两个相像的人或物之一	twin
感兴趣的事	interest
圈占	enclosure
股	share	thigh
肠	bowel	gut
肢	limb
肾	kidney
高地	height	highland
钢铁	steel
（鼓的）一击	beat
指责	charge
长辈	elder
蓝图	blueprint
肉	flesh	meat
“行”	yes
姓氏	surname
通行证	pass	passport
赊账	tick
经费	expenditure
织法	weave
显示器	display
狂欢	racket
并非完全真实的事	fiction
威胁	assault	danger	menace	threat
示意图	diagram	plan
[动]角鲨	hound
演奏台	console
相反的人[事物]	opposite
气温	temperature
学位证书	diploma
传真	fax
租赁物	lease
整套	cycle
婴儿时期	cradle
牛奶场	dairy
一生	life	lifetime
特权	faculty	freedom	privilege
火鸡	turkey
地表	earth
（英国大学的）名誉校长	chancellor
[医]赘生物	vegetation
破裂声	clap
口语重要的人	anybody
水珠	dew
幼儿园	kindergarten	nursery
（书等的）封面	cover
极面	polar
极小量	particle
应变量	function
（从事某种生意的）公司	house
变奏曲	variation
（处罚等）一回	dose
成果	consequence	fruit	hay	outcome
淡水流	fresh
类似铁铲的工具	paddle
光谱：辐射源	spectrum
马棚	stable
兄弟	brother
阶梯	ladder
罐子	jar
刷子	brush
裂纹	flaw
偏移	drift
（人、生命等的）衰退期	decline
水晶	crystal	pebble
周一	Monday
妻子	wife
防水物	waterproof
邮差	postman
健康有精神的面貌	bloom
诅骂	ban
（体育运动用的）厚垫子	mat
保险单	policy
定期存款	fixture
压平机	flatter
爆炸声	bang
顽皮	mischief
祖先	ancestor	father	root
激烈	heat	rage	violence
（尤指小说中的）宇宙飞船	spaceship
通讯	communication
邻国	neighbor
委屈	complaint
量筒	graduate
接合点	join	junction
一口气	breath
宿舍	dorm
留意	regard
老板	boss	employer	shopkeeper
榔头	hammer
一般原则	general
门诊部	clinic
抵达	arrival
邻近	vicinity
戏剧性事件[场面]	drama
人事部门	personnel
审定	criticism
墓穴	grave	tomb
烟草	tobacco	weed
（动物栖息的）穴	tunnel
口授	dictation
十个人	ten
学说	theory
噼拍声	clap
（某地的）妇女	daughter
器具	appliance	tool
隐士	solitary
举枪	salute
表现	performance	expression
用途	use
厢式货车	van
劳动者	worker
（管子或机器部件的）圈	collar
重奏	repetition
国际象棋	chess
准备	preparation	provision
福利	welfare
一张（通常指标准尺寸的纸）	sheet
市中心区	downtown
乘车旅行	drive
缆绳	cable
筹措	raise
有趣的故事	funny
证词	evidence
（对治安官或市长的尊称）阁下	worship
[法]强奸	rape
结节	knot
餐	meal
天文学	astronomy
院长	prefect
东正教信徒	eastern
（特指女子对男性的）迷恋	crush
两腿前后错跃	scissors
[生物学]膜	envelope
排骨	chop
枯竭	drought
突然袭击	raid
主角	principal
病室	ward
临床实习课	clinic
构成者	former
愤激	fry
祸根	mischief	ruin
操作停止	layoff
装腔作势	pose
[A-]柏拉图哲学信奉者	academic
石头	rock	stone
破坏	breach	destruction
蒸汽	steam
护肤膜	mask
合作	combination
[神]灵	substance
律金钱或财产的转让（契约）	settlement
主张、政见等变化无常的人	acrobat
账	account
特大号	imperial
〈美〉铁路信号所	tower
粉]	carbon
警员	policeman
耻辱	brand	reproach	scandal	disgrace
担保者	sponsor
警告	caution	notice
假日	holiday
雷电	bolt	lightning
[语言学]吸气音	click
知觉	feeling	sensation
证明人	reference
生而为人	personality
（物品的）边	surround
系数	ratio
来临	forthcoming
纸牌	card
休假	vacation
物体	body	object
<美>州长	governor
那个(that的名词复数)	those
集中	concentration
提神	refreshment
闲话	gossip	scandal
兔子皮毛	rabbit
罪过	sin
女衬衫	blouse
组合艺术品（由画	combine
联欢会	social
轻奏乐段	piano
游泳	bathe	plunge
某地区的人	neighborhood
优惠券	coupon
处于支配地位	advantage
胆量	courage	nerve
权重	weight
金	gold	grain
迫害的对象	witch
衣柜	wardrobe
（美）讲道台	desk
海豹	seal
超额量	excess
编织物	knit
圈占地	enclosure
量	amount	quantity	volume
挽回	retrieve
感受	feel	sensation
行会成员	craft
合成[运动]	resultant
协定	bargain	agreement
爵士乐	jazz
飞机制造业	aviation
消元式	resultant
少年读物	juvenile
碎屑	patch
冷漠	chill
加固物	reinforce
金刚石	diamond
男性后裔	son
出局	out
[音乐]固定唱法时的E音	me
动作	gesture	movement
十四岁	fourteen
天才	genius	talent	instinct
广播网	network
[人名]贾纽厄里	January
配件	equipment
美俚初学者	student
经常光顾	custom
能耐	ability
问答	dialog
硬币投币口	slot
选派	draft
标本	portrait	sample
击败	conquest
节录	excerpt
段落	paragraph	segment
个体生态学	ecology
弹簧	spring
所有人	owner
运动会	game	meet	meeting	sport
梯状物	ladder
大腿后部	ham
美俚核粒子园	zoo
学历	qualification
〈英〉合理的服装	rational
沉淀	settlement
元气	mercury
群花	blossom
（随食物或饮料）吞下的气	wind
刺	poke	prick	thorn	thrust
流行性感冒	flu
来源于拉丁语	June
刮	scrape	scratch
瓷器	china	porcelain
不可能的事	impossible
列	column
蕾丝	lace
语法	grammar
通票	coupon
分	cent	minute
刀	knife	sword
食橱	cupboard
布局	geography	layout
真实	true
科学工作者	scientist
手续	procedure
弥撒（祈祷、礼仪等）书的章节	proper
溜达	wander
啜泣（声）	sob
（社交性的）音乐会	musical
废旧物品	junk
成年	majority
美皮箱	luggage
美术家	artist
酒鬼	drunk	soak
泥炭沼	moss
支配自己生活的大事	religion
轻蔑的拒绝或不承认	despite
关系固定的情侣	steady
合并	marriage
病情	affection
风流韵事	affair
分解	analysis	breakdown	resolution
受骗	bite
（责打人用的）棍棒	rod
敬意	compliment	honor	respect
（常用于向孩子指出其愚蠢行为）傻孩子	silly
（政府）行政机关	administration
许诺	promise
辞别	leave
键盘	keyboard
污物	mud
地产	land	property
纨绔子弟	doll
分子	member	molecule
法官席	bench
关系	bearing	concern	connection	link	relation	relationship	tie
[机]冷塞	shut
倾斜度	lean
衣带	band
特大霓虹灯广告	spectacular
美任命	assignment
服役	service
天井	courtyard	court
实验	tentative	try	experiment
书记员	clerk
（气体、液体如水从管子里）流出	discharge
努力	effort	endeavor	labor
似吠声	bark
嘴唇	lip
官印	chop
观光	sightseeing	tour
雨水	water
角	angle	corner	horn
古希腊和古罗马艺术风格	antique
某些语言的（名词、代词和形容词）性的区分	gender
精神上的创伤	scar
内陆	inland
管家	steward
[语音学]声母	initial
意识	sense
戏法	magic	trick
失策	blunder	mistake
规章	regulation
（度假者、旅游者	camp
增加量	increase
手术室	surgery
古典音乐	classical
[物]入射	incidence
诉讼委托人	client
蒸汽（等于vapor）	vapour
宗教信仰	faith
手稿	manuscript
摘要	digest	resume	summary	abstract	excerpt
剩余物	over	remain	remainder
全体委员	committee
级别	grade	scale	step
反面	back
东西	bird	fish	thing
圣诞节	christmas
装货	shipment
[物]晶带	zone
人民	people
宾馆	hotel
壕沟	ditch
洋芋	potato
停止	arrest	cease	halt	stand	stop
特性	characteristic	property	speciality	specific	specific	trait
维持	maintenance
背信弃义的人	traitor
爱卖弄大道理者	philosopher
〈集合词〉青少年们	youth
寻欢作乐	jolly
纺]比尔	beer
溢流管	overflow
出身	birth	origin
步行者	pedestrian
可眺望四周的高地	overlook
无处	nowhere
[音]和声	harmony
平衡力	balance
重点	main
脸	face
女杰出人物	heroine
侨居地	colony
大纲	outline
鼓状物	drum
看守	guard	watch
加强器	intensive
脑	brain
右手	right
大惊小怪的人	fuss
完全屈从于压制	abandon
法律	legislation
脚	foot
改造	reclaim	reform
潮流	spirit	stream	tide
胶粘物	glue
喘气	gasp	pant
死线	deadline
六点	six
〈俚〉烈酒	sauce
马赛克	mosaic
机器	apparatus	machine
天使般的人	angel
预算	budget
证券交易额	turnover
殿后部队	rear
茁壮成长	thrift
伪善	hypocrisy
螺钉	bolt
钉子	nail
搭车	lift
相类似的人[事物]	like
（羊、猪等带前肋的）颈脊	rack
户外	open
烤肉叉	spit
光轮中的耶稣（圣母、上帝）圣像	majesty
少量的钱	hay	penny
（铁路的）无盖货车	truck
费用	charge	cost	premium	expenditure
电工	electrician
[宗]基督的献身	sacrifice
（人行道的）镶边	curb
锯齿形的线条、小径等	zigzag
鉴定人	judge
俚微笑	cheese
神经的）起端	origin
弯曲（处）	bend
树篱	hedge
继承人	heir	succession	successor
缘	rim
原木	log
口水	spit
受雇杀人的枪手	gun
经修理的东西	repair
锈病	rust
〈古〉和谐	symphony
错误	error	mistake	trip	wrong
诈骗	fake	have
车队	fleet
法典	code
[统]集体	collective
鲨鱼	shark
包裹物	envelope
护具	pad
欺诈	deceit	fraud
无意义的东西	rubbish
耐药量	tolerance
[摄影术]减薄	reduction
更新的行为或事例	update
行列	procession	rank	train
审判	judgement	trial
击球	shot
树胶	gum
虚构的事	myth
资源	capital	resource
一段音乐	strain
（运动或活动的）速度	tempo
喝彩	applause	cheer
微生物	germ	organism
[乐]乐句	idea
随笔	essay
军帽	cap
转变	conversion	transition	translation
招待	entertainment	hospitality	treat	invitation
零用钱	allowance
极少量	trace
（品质或情感的）标志	mark
公路	highway
散文	essay	prose
作家	pen
虚构的人	myth
足够维持闭居生活的收入	independence
标度盘	dial
瓷	porcelain
开票人	drawer
重建	recreation
自满	pride
织物	cloth	fabric	material	textile	weave	web
雄性动物	male	he
立方形	cube
蜜蜂	bee
[数]差数	difference
直立支柱	standard
撞击声	clash
[人名][英格兰人姓氏]弗赖迪可能是德意志或犹太人人名的英译	Friday
线圈	coil
主修科目	major
实数	real
[计算机]指令	command
棍枝	stick
溅泼声	splash
花式吹奏	flourish
华丽的辞藻	flourish
暂时的停顿	pause
不可能	impossible
轮廓	figure	outline	profile
喘息	gasp	pant
气管	canal
序祷	preface
用材林	timber
蓄积	reservoir
赤道	equator
解放	liberty	loose
马甲	vest
猪肉	pig	pork
周四	Thursday
排放出的物体	discharge
特大号商品	super
牵涉	implication
（美国）民主党的象征	donkey
（纸牌的）一副	pack
肉体美	build
差别	difference
圣…（冠于人名、地名之前）	saint
古牧师	clerk
手法	technique
疑问	question
（用于书名）指南	companion
（说的）话	word
灾难	disaster	fate	misfortune
连载小说	serial
难解之谜	riddle
摄影	shoot
望远镜	perspective	telescope
摄氏	centigrade
[非正式用语]大量	bunch
紧迫	drive	haste
校样	proof
捆	bunch	bundle
否决理由	veto
卷尺	tape
失败的事	failure
寄生植物	parasite
（气体等的）放出	evolution
铁器	iron
苦差事	grind	task
杂草	weed
拍打	flap
（缝纫或编织中的）一针	stitch
关闭（或断开、取消）状态	off
拍手	clap
（思想	path
州	state
衬边	mat
一大群	swarm
隐语	jargon
课本	book	textbook	tutor
[计算机科学]计算机病毒	virus
牧场	meadow	pasture
感光版	plate
含酒精的饮料	alcohol
旅馆	hotel
老兵	veteran
博士	doctor
[复数]（美国海、陆、空三军穿的）蓝色制服	blue
网状织物	net
[解剖]动脉	artery
有利条件	advantage
日期	date	when
猛撞	bang
剧场	theater
进退两难	dilemma
壶	jug
马铃薯	potato
（国家的）内政	interior
乘积	product
庙	temple
螫伤处	sting
罪犯	convict	criminal
（食用的）动植物油	fat
个人	private	individual
〈俚〉锚	hook
注释	comment
降落伞状物	parachute
背	back
大财主	millionaire
创作	composition
[商]（英）普通股	ordinary
更进步的人	improvement
敷用	application
胶囊	capsule
[逻辑学]全称命题	universal
表明	testimony	exhibition	indication
文明社会	civilization
体系结构	architecture
一群领导者	leadership
（羊的）晕倒病	sturdy
平原	champagne	plain
装填物	fill
十一个	eleven
永久性军事基地	installation
前	priority
用粉笔画的记号	chalk
编辑	edit	editor
镶嵌工艺	mosaic
报告	relation	report	account	advice
配乐	background
良好	goodness
一批备用药品	pharmacy
洗头	shampoo
拇指	thumb
屠户	butcher
新月状物	moon
尤指牛津、剑桥大学的）学监	dean
波涛	surge
搬运人	carrier
改善	improvement
冲	rush
授权证	warrant
节食	fast
固定在某位置的人或物	fixture
冬	winter
主要原则	outline
会堂	auditorium
养料	food
样品	pattern	sample	specimen
复叶的一片	leaflet
修女	religious	sister
戏团的）全部服装	wardrobe
〈口〉（报纸的）末版	final
适合	fit
总额	amount	gross
（顾问）医生	consultant
标记	badge	trademark
礼貌	courtesy	manner
（某种用途的）容器	pot
（内燃机的）火花塞	plug
不毛	poverty
[军]军医	surgeon
极乐	heaven
消防栓	plug
眼界	horizon	scope
对比	contrast
迷人的美	glamor
一份遗产（或赠与的财产）	portion
司祭	priest
樱桃色	cherry
英里	mile
肘形管	elbow
岛屿	island
末尾	last
暴行	outrage
备用零件	spare
围绕	enclosure	environment
锈菌	rust
真实情况	reality
基督	christ
预算案	budget
软毛	down	fur
百姓	civilian	vulgar
（表示正确无误的）记号	tick
喧嚣	uproar
参观者	visitor
车库	garage
跳马	horse
勤勉	application
吃草	browse
背离	departure
全体居民	population
蜜饯	preserve
速度	career	rate	speed	velocity
女性	feminine
同胞	brother
探求	search
发牌人	dealer
关联	link
动向	drift
蝴蝶结	knot
红肿部位	raw
苏打	soda
形势	aspect	situation	thing
乖戾	vinegar
傻瓜	donkey	fool	goose	stiff
（考虑到故事、报告、报道等的夸张或偏见等）不全信	discount
物数参量	parameter
游戏台	table
开幕	opening
千卡（食物所产生的能量单位）	calorie
倚靠	stay
介词	preposition
美妙的音乐	melody
祈祷（习惯）	prayer
[商]开盘	opening
喷雾	jet	spray
急忙	haste	hurry
“是”	yes
反射	flare
升高	up
名物	institution
航空站	terminal	airport
说话的态度	style
时期	day	epoch	period	season	tide
烘房	stove
虫	cloud	worm	insect
被抛弃的人[物]	discard
（身体的）擦伤部位	raw
工作周（一个星期中的工作时间）	week
（飞机或宇宙飞船的）舱门	hatch
[物理学]相位	phase
队形	formation
喜爱	regard	affection
[冶金学]激冷	chill
时机	occasion	tide	time
不毛之地	barren
唧唧声	peep
防护物	fence
虎狼之徒	tiger
电脑	computer
劣质的东西	rubbish
自我的一部分	me
出入口	door	mouth
香烟	cigaret
权利	right
交易所	exchange
资金	chest	finance
光辉	blaze
超过	excess
帽子	cap	hat
高温	heat
磁石	magnet
致敬	salute
声誉	prestige
西红柿	tomato
申请求职者	candidate
（野鸭等）群	team
滤光器	filter
（地下室）葡萄酒贮藏库	bin
产品	manufacture	produce	product	production	yield
图例	legend
危险的诱惑	siren
负号	minus
片断	episode
[航海]（商船的）大副	mate
新闻工作者	journalist
小品词	particle
笔状物	pencil
童男	virgin
创新	innovation
果核	core
葡萄渣	rape
总店	headquarters
投资的收益	yield
倾倒	overthrow
要洗的衣物的数量	wash
粉剂	dust
自行车	bicycle	cycle
麻醉药	drug
洞察力	perspective	insight
正式辩护	apology
汇成	return
爬行	creep
商店	shop	store
签名	signature
信念	belief	conviction	profession
妇女饰品	accessory
引进	introduction
信心	confidence	reliance
出现	appearance	arrival	occurrence	advent
懒汉	poke	soldier
（文学作品等的）粗制滥造	manufacture
吊舱	car
物主身份	ownership
拖运货物的距离	haul
（尤指男女间的）品行	moral
实验班	workshop
专有特权	peculiar
古女王	princess
三明治	sandwich
税务局	revenue
特赞	proper
滑行装置	ski
官方使命	mission
全部	full	whole
邮费	postage
乐谱	music	score
酒	bottle	drink	liquor	poison
〈口〉德国人	sausage
浸	bath
停车站	stop
[医]并发症	complication
抵押品	guarantee	hostage
机械装置	machinery
救护车	ambulance
浬	knot
类推	analogy
调查（或研究）的结果	finding
群	cluster	group
女王	queen
语气	mood	strain
国王	king
契约	bargain	bond	contract	engagement	obligation
枝干	limb
破片	shiver
[哲学]一般概念	universal
浅碟形盆地	saucer
[高尔夫球]多于对方的一次击球	odd
羹	soup
残余	remain	remains	remnant
匙桨	spoon
（一批）供应品	provision
振幅	swing
棍棒	club	stick
羊	sheep
最后加工	perfection
丑事	scandal
垂直线	vertical
（帮助警方破案的）线索	clue
商业中心	town
密封	seal
（尤指旅馆或餐馆的）星级	star
蟹肉	crab
冒险经历	adventure
发明才能	invention
海港	harbor
充足	plenty
集体	outfit
同龄人	contemporary
时间	hour	time	when
肘部	elbow
[商]势力范围	territory
出席者	assistance	attendance
方位	aspect	bearing	lay	position
无关紧要的人[事]	nothing
一星期	week
缺点	defect	deficiency	drawback	fault	flaw	shortage	shortcoming
淀粉质或糖类食物	carbohydrate
善良	good	goodness
名家	great
存在期	lifetime
狭槽	slot
医药	medicine
齿	tooth
火焰	blaze	flame
集合	assembly	rally	syndrome
天使的级别或等级	hierarchy
概要	brief	summary
悬臂	bracket	console
有益	commodity
级数	series
势力	influence
社会团体	community
阻力	drag	resistance
蚂蚁	ant
花环	wreath
没有任何…	zero
代理	agency
息票	coupon
藏衣室	wardrobe
牵引器	tractor
软件	software
围巾	handkerchief	scarf	wrap
化学制品	chemical
增补	supplement
（入场券的）售得金额	take
侧部的东西	lateral
毕业文凭	diploma
适用	application
赞助人	patron
小家伙	chap
[数]幅角	argument
激增	boom	explosion
[语言学]爆破音	explosive
蛋白（质）	protein
诚实	integrity
小汽锅	kettle
副手	deputy	secondary
失业率	unemployment
大批观众	gallery
配额	quota
（举行盛事的）夜晚	night
限定继承	entail
婚姻生活	marriage
东	east
祝贺	greeting	congratulation
辞去	vacation
海中的）游泳	bathe
广袤	scope
座位	place	seat
设计者	projector
怪人	crazy	odd	original	put	queer
男子	fellow	mankind
免抢税	blackmail
挑选	selection
美俚〉后代	sprout
[机]滑动部分	slipper
卡（热量单位）	calorie
一阵子	snatch
植物（总称）	vegetation
领主	lord
投稿	contribution
弹药	bullet
母亲	mother
规定饮食	diet
寓所	apartment	dwelling
（个人的）固定收入	revenue
猛烈	rage	violence
模型	former	model	mould	portrait	shape
西北	northwest
偷偷摸摸的举动	sneak
对自然环境的保护	conservation
传令兵	messenger	orderly
当地人	native
英谷物	corn
宠爱	favor
日光	daylight	light	sunshine
下级	subordinate
防水布	waterproof
生产者	generator
阳台	balcony
浓厚	density
大部分	bulk	most
退化的动物	degenerate
（持续一段时间的状况的）改变	break
旁听席	gallery
彩排	rehearsal
小羊	lamb
不	no
外科学	surgery
藏匿处	nest
前程	expectation
可匹敌者	comparative
小淘气	monkey
三	three
一部分	piece	portion	slice
制裁	sanction
僵化的事物	fossil
[建]竖杆	vertical
葱头	onion
英〉同specialty	speciality
防护套	lag
滑雪	ski
[影]演播室	studio
化学药品	chemical
旋转木马	roundabout
射中接近靶心部分的一发	inner
[光]物镜	objective
干草堆	stack
心理影响	psychology
大规模攻势	push
叛国（罪）	treason
男人	man
增味剂	dose
霸主	mistress
誓言	oath	pledge
最坏的事情	worst
毒气	gas
〈英〉担保	caution
[天]伴星(=~star)	companion
〈英口〉厕所	rear
新闻纸	newspaper
请安	courtesy
巡航	cruise
全套装备	outfit
理财	economy
检测器	detector
打翻	overthrow
喷射流	jet
迷信	superstition
必不可少的东西	essential
[化学]（染色的）助剂	assistant
钢轨	rail
赏钱	fee
连词	conjunction
道歉认错	apology
忠于…感情	loyalty
人口	population
皱眉	frown
地下组织或活动	underground
膝	knee	lap
膜	layer
负担	burden	load	tax
[数]似然	likelihood
凭冲动行事	impulse
胜利	triumph	victory
小雨	sprinkle
未完成的部分	fragment
交情	fellowship
冻结	freeze
头痛	headache
爱说话的人	pie
歪斜	glance	tilt
除去	removal
德芙（巧克力品牌）	dove
治愈	cure
撑夹桅杆的加固夹箍	fish
主妇	mistress
动物油脂	grease
轻敲	tap
特色	characteristic	difference	particular
逆转	turnover
神学家	divine	doctor
公诸于众的状况	publicity
（表示友谊的）干杯	pledge
活塞筒	barrel
高架道路	overpass
主管人员	chief	governor
紧要关头	clutch	crisis
[女子名]伊斯特尔来源于古英语春之女神Eostre	Easter
公寓楼	apartment
[法]（原告的）申诉	declaration
阑尾	appendix
广大无边的空间	vast
锈色	rust
[建筑]拐角	coin
一拳	dig
漂亮的人（或东西）	pretty
酋长	chief
商品交易会	fair
规格	specification	standard
滑水橇	ski
病毒性疾病	virus
百万富翁	millionaire
烟道	tunnel
一种乡村舞蹈	hay
娱乐节目	entertainment
保险费	premium	insurance
情夫	lover
改良	reform	improvement
优点	asset	merit	quality	strength
合成物	composite	synthetic
边	border	edge	side	verge
[化学]当量	equivalent
弯曲部分	hook	loop
楼房	building
口供	declaration
西北部	northwest
驻地	residence	station
（射击的）靶子	target
糖果	candy	sweet
旋转的行为	spin
味觉	taste
水晶透镜	pebble
（酿酒配料的）均衡	balance
基础建设	infrastructure
搀杂品	alloy
发音方法	pronunciation
低劣	poverty
忙乱	fuss
退休	retire
渴望	anxiety	rage	wish
六个	six
耶路撒冷古神殿	temple
衬垫	liner	pad
司炉工	fireman
特级品	super	imperial
抵押权	mortgage
强制（力）	logic
降落伞背带	harness
癌症	cancer
工钱	hire
滑稽连环漫画栏	funny
颂辞	tribute
管理人员	management
一刹那	twinkle
旗帜	banner	flag
猪的肩肉	picnic
拥挤的人群	crush	squeeze
挖苦	dig
突然发出的巨响	crash
定额	quota
滋生地	nursery	soil
人群	crowd	multitude	resort
虚构的或想像出的事	fiction
诅咒	ban	curse	oath
劳动	labor	thrift
眺望处	outlook	prospect
（作单位的）百	cent
草稿	draft	outline
精神病学	psychiatry
激烈的竞争	battle
（毒品或酒精的）效力	kick
（诗歌的）叠句	refrain
贸易	commerce	trade
缸	jar
青铜	bronze
投资额	investment
资助者	friend
膳食	board
小船	boat
年鉴	yearly
放任	loose	abandon
管辖	government
通勤来往的路程	commute
（证券的）场外市场	curb
跳跃	leap	skip	spring
〈英〉（比赛）得分纪录	chalk
阀	valve
[计算机]编码	code
阄	lot
羞怯的人	violet
偏见	bias	prejudice
似非而是的论点	paradox
（美国南北战争时与南方作战的）北部各州	north
队	team
艰难	hardship	rough
进步	progress	improvement
培训会	seminar
沟渠	canal	ditch
（身心机能的）失调	disorder
种族	people	race
湿透	soak
防止损失（尤指金钱）的手段	hedge
一眨眼间	wink
用或似用带尖武器刺的伤口	stab
公众信息	publicity
原子	atom
高温潮湿	humidity
狂笑	roar
游荡	wander
打击	blow	shock	stun
尊敬	consideration	esteem	honor	regard	worship
握力	grip
短程穿梭运行的飞机（或火车	shuttle
休息厅	lounge
定量	quantity
禽	bird
（连衣裙、外衣等的）下摆	skirt
通讯中用以代替字母n的词	November
正当	right
发明	invention
不义行为	wrong
扮演少年角色的演员	juvenile
表演	show	spectacle
休克	shock
对称美	symmetry
利害关系	interest
尖啸声	zip
[纺]尼龙	nylon
董事会	board
公司或企业	concern
（生来的）白痴	natural
集会	assembly
国际体育比赛	international
十几岁的青少年	teenager
密切结合	marriage
滴	drop
谷粒	grain
[机械学]导向器（或轴）	pilot
（名誉等的）损害	compromise
听众	audience
（外）祖母	grandmother
藏书	library
职位较低者	junior
铅字	type
详述	detail	rehearsal	specification
十点钟	ten
（牛马、骆驼的）尿	stale
合成纤维	synthetic
花招	maneuver
丰富	plenty	wealth	abundance
嫩叶	leaflet
院子	courtyard	yard	court
[占星]（左右人命运的）星相	planet
救球	save
初步措施	preliminary
工业	manufacture	industry
支付金额	cash
政治斗争	politics
遗憾	regret
结构（物）	construct
县民	county
[医]疡肿	boil
昨天	yesterday
居住时间	residence
兴奋	excitement
[D-][天文学]天龙（星座）	dragon
怒气	anger	temper
顶端	tip
登峰造极	it
含义是“羊栏”(sheepfold)	Easter
俚绝妙的人	it
层进法	climax
容易	ease	facility
（因失误而打出的）曲线球	slice
邮票	stamp
百个	century
纤维	fiber
三十的记号	thirty
输出[出口]物	export
松脆物	crisp
恭维	compliment
（命运等的）折磨	buffet
百万	million
温暖	warmth
（事情的）处置	disposal
担架	litter
时令	season
针状物	needle
〈俚〉无理的回答	lip
被保险人或物	risk
候选人提拔会	primary
[俚语]醉汉	soak
羊倌	shepherd
较量	battle
[宗]日课	lesson
追捕	chase
加班	overtime
抗议	protest
垃圾箱	bin
劣势	drawback
（为某目的或某段时间内的）花销	spend
饭馆	restaurant
丑闻	scandal
连锁店或旅馆系列的事物	chain
肾脏	kidney
存款	deposit	account
风景画	scenery
骄傲	pride	importance
管弦乐队	orchestra
（辩护）律师	advocate
开口	hatch
最高阶层	summit
〈美〉（火车的）司机	engineer
编法	weave
开端	dawn	offset	outset	preface
三年级生	junior
故事片	feature
（空气中的）湿度	humidity
典礼	ceremony	ritual	exercise
静悄悄的流水	glide
美假花	artificial
临时工	temporary
洋	ocean
单人纸牌游戏	patience
光景	spectacle
保险额	risk
（动物的）臭迹	scent
通行税	toll
肉用公牛	steer
失业	unemployment
斜坡	hill	slope	tilt	incline
立场观点善变的人	acrobat
停工	layoff
根据	base	score
草图	cartoon	sketch
鸡眼	corn
亚麻布	linen
his	all
轮廓线	outline
敲诈	blackmail	hijack	racket
滤波器	filter
中部	middle	midst
退隐	retire
捐赠	contribution	contribution	donate
土豆皮	jacket
公共汽车	bus
外围物	surround
省份	province
咳嗽病	cough
（时间	priority
司铎	priest
敌对行动	incident
金属元素	metal
蛋	egg
笛声	whistle
参与国	participant
水源	source
娱乐活动	fun
蛆	gentle
蛇	snake
睡眠	sleep
禁止	ban
昏倒	faint
被挑选的人[事物]	selection
商行	firm
团结一致	unity
动词被动形式	passive
帝位	purple	throne
抢夺	scramble
大船上的小艇	launch
番茄	tomato
文学名著	classic
〈数〉（相）约	cancel
绊倒	trip
处理	transaction
蹙额	frown
黄种人	yellow
放牧	browse	graze	pasture
事故	casualty	slip	accident
被（爱情等）迷住的人	captive
权力	arm	authority	might	muscle	power	sword
献祭	sacrifice
一篮	basket
[植]柔荑花序（如柳絮）	chat
隔开的小间	booth
驱动器	driver
理由	call	occasion	reason	sake	score	why	account
特殊病例分析	clinic
天（空）	sky
鼓掌	clap
烟囱状东西	chimney
（时间的）间隔	distance
法庭	forum	court
偶然	chance	accident	accidental
重现	recreation
（用于姓名前）爵士	sir
柔软之物	soft
流血	blood
攻势	offensive
囚犯	lag	prisoner
补救办法	compensation	help	remedy
坏人	bad
公司	company	corporation	firm
微贱的人	insect
[电]碳精棒[片	carbon
代表	delegate	deputy	representative
坏事	bad	evil
鉴定	appraisal	criticism	judgement	opinion	expertise
来源于古英语	Easter	Easter
[计算机]数据	data
教诲	instruction
思想	concept	thought
效率	efficiency
记录	entry	log	record	register
彻底的失败	bomb	disaster
草本植物	herb	dock
[航海]拖船	tug
有机体系	organism
面容	face
海水	water
操场	playground
疏忽	blunder	lapse
邮务员	mail
龙船	dragon
期刊	bulletin	journal	periodical
体重	weight
蘑菇	mushroom
捕食（习性）	prey
色彩鲜艳	glow
缺乏主见或轻易盲从的人	sheep
处罚	sanction
运用头脑（或身体）的能力	use
理想的东西	it
周围	circumference	enviroment	suburb	environment
大理石	marble
配合	fit
平局	draw	tie
终点站	terminal
说服	conviction
翻筋斗	tumble
探头	probe
缔造者	architect
烤面包	toast
运输公司	carrier
（男）警察	policeman
判定	opinion
一个月的时间	month
黏胶	gum
[逻]前提	hypothesis
驾驶室	cab
语短语	phrase
奇人	curiosity	myth	wonder
台巾	scarf
[体育运动]易手	turnover
口侥幸逃过	shave
令人兴奋的经历	upper
奇事	myth
合成体	complex
拼命的叫喊声	scream
原则	fundamental	principle
密码组合	combination
[语]长音节	long
皮带	strap
白种人	white
黑色	black
（相对于灵魂而言的）人体	clay
洗好的衣服	laundry
（椰子等植物的）白色汁液	milk
火炉	stove	furnace
北方发达国家（尤指欧洲和北美各国）	north
有轨电车轨道	tram
〈美〉律师	lip
（服装的）长尺寸	long
深谷	valley
无足轻重的人	nobody
对应的人	analogue
诗日出的地方	sunrise
类比	analogy	parallel
动态	dynamic
白面儿	heroin
和谐	concert	harmony	tune	accordance
溜冰鞋	skate
补充物	augment	complement	supplement
弟子	child	descendant
攀	mount
静脉	vein
吸气	sniff	inspiration
晴朗	sunshine
一把（的量）	handful
[俚语]美女	tomato
月亮	moon
放大器	amplifier
矿	mine	ore
令人不快（或讨厌）的人	pig
（戏剧或电影的）戏装	costume
午后小吃	tea
功劳	desert	exploit
数组	array
悲伤	grief
甜瓜	melon
不确定性	maybe
知	mind
参议员	senator
监测仪	monitor
信号旗	flag
矢	arrow
装配	assembly
矛	shaft	spear
酒店业主	host
消沉	damp
古典芭蕾舞大师	poet
深红色	cardinal	ruby	wine
大师傅	chef
牢笼	prison
（总称）牛	cattle
菜园	garden
大块	bulk
（墙壁的）初涂	render
爱好	appetite	bias	fancy	like	passion	interest
诊所	clinic	surgery
山肩	shoulder
忠心	loyalty
困境	bind	corner	dilemma	extreme	fix	jam	mess	plight	soup
死尸	stiff
干劲	drive	go
构成部分	constituent
著作	literature	work	writing
变化	change	shift	variation	variety
（板球）零分	duck
浅处	shallow
指甲	nail
战争期间	war
回嘴	retort
港口	port
中心人物	sun
请求	application	demand	desire	motion	petition	plea
版次	edition
烦恼（等于annoyance）	annoy
表达能力	language
代表团成员	delegate
雄鸡的啼声	crow
失去联系	silence
支托（或握持）…之物	holder
审查	inquiry
先令（英国1971年以前的货币单位	shilling
果断	decision
镶边	border
抱有希望的理由	hope
（因无知、粗心等造成）的错误	blunder
容器	bin	pocket	recipient	vessel	container
上锁的人	locker
实力	efficiency
津贴	benefit	subsidy	allowance
（公共）厕所	convenience
牧师职位	ministry
行话	jargon
追求的目标	ambition
姿势	gesture	pose	posture
（民选的）市长	mayor
爱好者	audience	lover
伪装品	disguise
批判	criticism
讹诈	racket
物理学家	physicist
成年的人或动物	adult
管道	canal
卵石花纹	pebble
[语音学]消失音	vanish
（袖子等上的）褶皱	tuck
山坡	climb
鞋楦（做鞋的模型）	last
依赖	reliance
水果等）外皮	skin
柱顶石	summer
大学生活	campus
皮	leather	skin
奉承话	butter
天理	nature
六弦琴	guitar
译文	version
派	pie
自豪	dignity
[军]待命士兵	casual
已婚妇女	wife
毁灭的原因	destruction
脚步	foot	step
（铁路）旅客车厢	coach
短文	brief
药用盐	salt
孩子	child	son
贬同性恋者	queer
废词	obsolete
心	heart	mind
应缴款（如俱乐部会费）	due
（人体摄入的动植物）脂肪	fat
（英国）模拟考试	mock
迹象	evidence	hint
秘书	secretary
（管风琴的）音栓	stop
废话	junk	nonsense	rubbish	trash
[自]代码字典	dictionary
[物]电平	level
猪	pig
赠品	gift
猫	cat
[自]（数据安排的）形式	format
周日	Sunday
右边	right
员工	personnel	worker
临近	forthcoming
恐慌	flap	panic	scare
[体]选拔赛	trial
（潜水员过快浮出水面造成的）减压病	bend
中学生	student
尸骨	bone
独居者	solitary
索赔	claim
船舱的顶板	overhead
使人讨厌的人[物]	bore
菜	menu
敬畏	awe
优雅	grace	polish
[数]交集	intersection
生活呆板的人	vegetable
艺术作品	art
[植]桔树	orange
[医]癣	tiny
破产者	bankrupt
语言	language	tongue
学分	credit
专家的意见	expertise
表面不平	rub
非正式宝石（尤指钻石）	rock
微动	stir
质点	particle
（英）王室	household
个人的事	affair
蚊子	mosquito
空想的产物	fantasy
间歇	break	interim
晚会	evening
壮观的场面	spectacular
年史	page
溢出（量）	spill
建筑物	building	construction	structure
半成品	raw
防护用品	preserve
一批	batch	parcel
（贝、卵、坚果等的）壳	shell
足以媲美的人	answer
谜	mystery
下摆	lap
包裹	pack	package	parcel
[史]方镞箭	quarrel
（主持会议的）主席	chairman
上个	last
乳房	bosom	breast
小冲突	brush
（非本土的）外来动植物	foreigner
农耕	agriculture
反目	quarrel
远处	beyond	distance
总结	summary
臭迹	trail
很可能的事	probable
会话	conversation	dialog
机器人	clone	robot
醉汉	drunk
盗贼	thief
飞翔	flight	wing
浮华	flash	vanity
控制	clutch	grasp	hold	regulation	restraint
裂缝	crack	flaw	leak	seam	slit	split	tear
（速度）比赛	race
不幸	disaster	misery	misfortune	distress
服从	obedience
退伍军人	veteran
外交上的）报导	advice
自称者	professor
一群显赫的（出色的）人物	galaxy
盛会	feast
情妇	lover	mistress
（与复数动词连用）人员	personnel
协助	hand
神秘	mystery
甘露酒	cordial
花粉	dust
昌盛	health	prosperity	speed
本地居民（律师、教士、医生）	local
性质	characteristic
（消除误会后）和解	explanation
自然规律	necessity
[方言]讲的话	tell
（大、中、小学的）管理人员	staff
[植]营养体生长	vegetation
方巾	handkerchief
章程	rule
申请表格	application
公民	citizen
宣读	reading
朝圣者	pilgrim
向导	guide	pilot
热带地方	tropic
记录员	recorder
（植物的）荚	capsule
私事	privacy	affair
持久	duration
法企业家	entrepreneur
时态	tense
厄运	doom	misfortune	weird
天鹅	swan
储藏处	storage
教授	professor
席子	mat
关口	pass
（对规则、危险等的）藐视	contempt
静电	electricity	static
不符合（之处）	discrepancy
公墓	cemetery
培育	nurture
毒药	poison
（套叠在一起的）一套物件	nest
（森林、猎场等的）看守小屋	lodge
免责特权	privilege
小卡车	pickup
步幅	pace	stride
破布	rag
惊愕	startle	dismay
绰号	nickname	surname
丝线	twist
二十	twenty
航道	lane
议事日程	agenda
长裤	long
习性	habit
（有特殊用途或专属某人的）豪华寓所	apartment
（骑兵队等的）急袭	raid
尼龙织品	nylon
全体教职员	faculty
炽热	glow
辅助设备	assistance	auxiliary	aid
〈比喻〉可以逐渐扩大作用的开端	wedge
故障	breakdown	trouble
童子军小队	patrol
分隔	division
〈比喻〉神秘的变化（过程）	chemistry
伙伴	partner	party	peer
测量仪器	gauge
小号	trumpet
使节	ambassador
清楚	clarity
禁猎地	preserve
维护	behalf	maintenance
重要材料	substantial
工作作风官僚	camel
洞	hole	hollow
口名人	institution
当中	midst
（下棋的）一着	tempo
联合会	federation
不理	disregard
中心点	centre
厘米	centimetre
乘轮船旅行	steam
青草	grass
藓沼	moss
公正	justice
有影响的人（或事物）	influence
吹嘘	puff
[天]巨蟹座	cancer
来回	return
汽水	mineral	pop	soda
贫困	want	distress
（鸟的）绒羽	down
圆鼓鼓像瓜似的东西	melon
断头机	maiden
神职	ministry
[乐]全阶第五音	dominant
突然的悲痛	wrench
交界面	interface
乐器	instrument
相识的人	acquaintance
生活方式	living	manner
幻想	fantasy
放映期	run
叫牌	bid	declaration
卡片	card
（河的）岸	bank
（原子）核	nucleus
（打字机等的）键	key
干线	artery	highway
革新者	revolutionary
绘画	drawing	painting
餐巾	napkin
清查	inventory
实践	practice
驾船人	sailor
书目	bibliography
疼爱	love
投射物	missile
[地]冰碛土（物）	till
婴儿	baby	infant
老兄	mate
物惯性	inertia
放映机	projector
点心	refreshment	snack
欺骗	deceit	sell
[医]愈合	intention
入场权	entrance
猎物（指鸟兽等）	chase
狭窄的水道	narrow
使人欢快的事物（或活动）	feast
界限	bound	confine	horizon	limit	verge	compass
专业用语	dialect
终端	terminal
牛排	steak
尿布	napkin
极长的一段时间	forever
零位	zero
湾	bay
爱情	love
比赛	battle	combat	competition	contest	game	match	play
泳装	costume
[数	particle
（中小学生对男教师的称呼）先生	sir
先驱者	pioneer
完成	finish
帆布	canvas
[机]油盒	cellar
投票用纸	ballot
湖	lake
[军]刀枪操练	manual
香蕉	banana
王室法律顾问	silk
疯狂	rage
演讲者	speaker
性交	commerce
收益	profit	revenue	win
公用通道	highway
垃圾场	dump
海峡	channel	narrow	neck
荒野	wild
看电影	cinema
线	thread
特殊荣幸	privilege
[心理学]情境	situation
纸	paper	sheet
大师	great	master	pope
（人的）语言知识及运用能力	grammar
革命者	revolutionary
（食物、药物等的）一批生产的量	batch
可靠的人	reliable
镇定	calm
使他们的船只或触礁或驶入危险水域）	siren
套管	sleeve
〈美俚〉力量悬殊得可笑的体育比赛	laughter
跨度	span
古祖先	predecessor
束缚	bond	tie
碳精电极	carbon
炸裂	explosion
萦绕	obsession
荒谬的念头	nonsense
用具	tackle
老弟〔工人	mate
手指	digital	finger
本质	being	color	entity	essence	kind	root	substantial	texture	internal
自愿地做的工作	voluntary
回忆	memory
声响	noise	sound
半边屁股	cheek
音调	sound
海绵状物	sponge
千位数	thousand
温度计	thermometer
涉及	reference
奖牌	medal
隐情	catch
购物	shop
骇人听闻的事件	outrage
重击	sock
引导	guidance
不活动	inertia
鱼	fish
印痕	print
杂乱一团	huddle
撒布	scatter
防水材料	waterproof
规范	criterion	norm
一下工夫	snatch
一瞬间	flash
特征	character	characteristic	feature	stamp	temper
饮料	beverage	drink
块状物	cake
占领	capture	occupation
[哲]批判主义	criticism
（劳资）纠纷	dispute
像圆屋顶一样的东西	dome
盗窃之物	theft
见识	judgement	scope
至交	intimate
喜好	like
短麻屑	tow
投篮得分	basket
〈美俚〉跳舞	crawl
轻舟	canoe
食古不化的人	fossil
单数形式（的词）	singular
瘀伤	bruise
画像	picture
新学生	recruit
深紫色	grape
自治权	autonomy
扬言	boast
变迁	shift	transition
食物混合配料	mix
统一体	unity
旋转式机器	rotary
生产	production
（政府的）部	ministry
（化验的）取样	sample
前提	premise
肺病	consumption
单位	unit
巨流	river
讽刺画	cartoon
有用的东西	asset
（船或屋顶等的）肋拱	rib
〈口〉金粉	dust
经文	prayer
绘画作品	paint
粪尿	soil
附属机构	auxiliary
合身	fit
俚可卡因	coke
地理（学）	geography
（集合词）全家人	household
上级	senior	superior
红宝石色	ruby
委员长	chairman
男神	god
大群	tribe
[数]优先次序	priority
报纸	newspaper
农夫	peasant
污迹	blur
瓶子	bottle
合唱	chorus
扣环	clasp
集装箱	container
影响力	pull
常用于英式英语	cabbage	costume
行动者	actor
鉴定书	survey
生物体	organism
礼堂	auditorium
个人财产	estate
刘海	fringe
熟人	acquaintance
浪费	waste
[军]义勇军	volunteer
备用轮胎	spare
花样	pattern	flourish
继承权	succession
[数]数列	sequence
更新的信息	update
预修	preparation
（收音机等的）旋钮	knob
深渊	deep	profound
堂[表]兄弟姊妹	cousin
必要	call
审稿人	reader
（社会思想等的）趋势	climate
南腔北调的混合语	jargon
可耻的人	shame
即溶饮料	instant
酒馆侍者	drawer
[医]药方	prescription
[宗]天启	revelation
淘气鬼	devil	monkey	silly
三十个	thirty
加速[助推]器	boost
周围的事物(surrounding的名词复数)	surroundings
[复数]总收入	revenue
格斗	combat
[史]行政长官	prior
（经过试验、检验或体验发表的）决定	verdict
退步	setback
掷硬币决定	toss
长外衣	gown
有…底的-soled	sole
[古]空出	vacation
研细的程度	grind
明晰	clarity
[计]（电脑的）总线	bus
踵状物	heel
天才人物	genius
数指数	index
烫发	permanent
谋略	maneuver
履行	performance
拘留	arrest
表决	vote
建筑师	architect
约束力	restraint	sanction
肉汁	juice
（力量、健康、品格、权力、价值等的）衰退	decline
真实的写照	mirror
说话者	speaker
螺纹	thread
扁平槽	flatter
记忆	memory	mind
[医]导管	bypass
美北美洲大陆	continent
二十个	twenty
口真空吸尘器	vacuum
其间	meantime	meanwhile
节拍	beat
[医]（疾病的第…）期	stadium
旧报纸	newspaper
教员	professor	teacher
[生]培养基	medium
方向	aspect	direction	orientation	way
总计	tale	total
小声低语	mutter
夜盗	burglar
持有者	holder
性别	gender	sex
调式	mode
两侧相对的物体	cheek
[常作复数]（人生事件中的）时运	fortune
（指已提到过或已知的人或事物）那	those
被子	quilt
峭壁	cliff	scar
长期论战或长期作战	battle
政权	power	regime
[戏]道具	property
女用小提包	purse
昏乱	whirl
掣肘的事情	odds
圣经	bible
电影	film	movie
转换器	switch
韵文	metric	poem	song	verse
女房东	landlady
菠萝	pine
阴间	hell
撤销	cancel
输入电路	input
鼓励	sanction	incentive
第一位	primary
额外的事物	extra
极寒时候	dead
运动场	field	stadium
波道	channel
音延	duration
理发店(=barber'sshop)	barber
貌	spear
森罗万象	universe
飓风般猛烈的东西	hurricane
小麦	wheat
替罪羊	goat
历程	journey
不足	deficiency	failure	lack	minus	poverty	shortage
优美	polish
内务	interior
谈吐	address
素材	material
绿色蔬菜	green
方案	formula	project
不忠	treason
杯、盘、碟等的总称	china
董事	director
投标	bid	tender
患者	patient
翻滚	turnover
美俚（铁路货车的最后一节）守车	zoo
浅盘	tray
短途旅行	outing	excursion
青铜艺术品	bronze
器材	equipment	fitting
一圈跑道	lap
电钮	button
（塑料或金属的）夹子	clip
受宠的人	pet
人物简介	profile
技能	quality	skill	technique
传统	heritage	tradition
石油层	pool
[化]锌	zinc
耶稣	king
和平	peace
蟋蟀	cricket
乘客	fare	fare	passenger
古代理店	factory
抖动	quiver
[电]电池	battery
瞒报所得的收入	skim
熔炉	furnace
挑剔的人	critic
机智	salt	wit
有礼貌的举止[言词]	courtesy
把戏	trick
给予援助或安慰的人或事	comfort
[戏]旁白	aside
野外	open
研究员职位	fellowship
[动]颌毛	beard
二十年代	twenty
（光、声、色等的）力度	strength
气球	balloon
为祭祀杀死的动物（或人）	victim
渡口	ferry
路线	path	track
旅行者	pilgrim	tourist
（一篇报道的）补充部分	add
中间物	medium	intermediate
突如其来的强劲气流	blast
治理	government
恶意	spite
盛零碎物品的容器	tidy
工装	blouse
[乐]滑音	glide
无怨接受（逆境、困境等）	acceptance
测验	exam	test
维生素	vitamin
假定	perhaps	assumption
[法]（权利等的）失效	lapse
（提供某方面信息的）办事处	bureau
骨瘦如柴的人（或动物）	skeleton
〈英〉管赛马房的马夫	lad
佃农	peasant
变动	variation
标签	label	tag	ticket
盖印	impression
[植物学]裂	gap
分析室	lab
亲爱的	sugar
刽子手	butcher
入场	entry
阵雨	shower
霉	mould
户外烧烤野餐	roast
鞋帮	upper
篮球	basketball
期间	duration
吊厢	car
逐出教门	curse
导游	guide
从科学实验中提取的价值	data
单身汉	bachelor
阴虱	crab
外壳	crust	envelope	shell
知识（表示多方面的知识时有复数knowledges这一用法）	knowledge
十三岁到十九岁的少年	teenager
勋绩	exploit
过低评价	underestimate
英（都市住宅的）地下煤窖	cellar
〈美〉刚进社交界的姑娘	bud
背后	rear
燃烧的颗粒	spark
追赶	pursuit
香味	perfume	scent
详细情节	particular
审问	hearing
好斗分子	militant
契机	momentum
豌豆	pea
流言蜚语	gossip	report	scandal
口（数量、价格等）增加	hike
前例	precedent
文体	language	style
纯洁的人	dove
演习	rehearsal
陈列	display	exhibit	exhibition
总教堂	cathedral
连锁	chain
满盘	tray
（用作装饰的）小树枝	spray
猫科动物	cat
避免浪费	conservation
恶棍	tough
阻挡	tackle
不敬	violence
果汁	juice
唱机唱头	pickup
使用	employment	usage
舞台面	scenery
做法	manner
碰见	encounter
（学问等的）范围	region
补贴	subsidy	allowance
和谐的东西	symphony
延迟	delay
安逸	ease	leisure
男子汉	man
部署或者秩序	stagger
号码	number
神秘的事物	mystery
战斗	combat	conflict	fight
〈非正式〉好处	carrot
理性	reason	sense
鲸等）	cow
俚脑袋	cabbage
[英史]堡寨	peel
周期	circle	cycle
故乡	country
国土	country	soil
知己	confident
借	borrow
恐惧	dread	scare
黑暗	dark	black
矿物	mineral
应得到的东西	due
[计]存储器	memory
[英史]什一税	borrow
英国政治工党	lab
敌手	opponent
幕间休息	interval
渔夫	fisherman
〈古〉好笑的事	laughter
烤箱	oven
地表突然而猛烈的变动	catastrophe
航空公司	airline
半神的勇士	hero
绳结	knot
[常用复数]全国性比赛	national
相称	proportion
冷落	slight
小睡	nap
[动	whirl
柜橱	cabinet	cupboard
巨大的成就	triumph
[印]现代字体	modern
纬度	latitude
象棋中的车	castle
[化]朊	protein
[计算机]程序	routine
酬金	hire	reward
（室内）便鞋	slipper
（体系的）结构	framework
供野餐吃的食品	picnic
很少的钱	peanut
椭圆形	oval
鸡肉	chicken
片断插曲	sequence
[解]瞳孔	pupil
吵架	fight	scrap
国货	domestic
一号	first
液体	fluid	liquid	wet
专利权	patent
补集（数）	complement
庄重	gravity
体育比赛	meet
运用	application	exercise
小圆点	dot
优势	edge
节目主持人	host
极相似的人或物	counterpart
模特儿	model
陷阱	hook	net
未确定	doubt
荒地	desert	waste
概论	panorama
狡诈	craft
无稽之谈	fable
瘦腿紧身裤	jeans
失望	damp	sell
朴实无华的东西	plain
拐角	corner
鸟群	flock
体温表	thermometer
上述	above
尝试	effort	essay	stab	tentative	try	experiment
嫁妆	portion
环境	condition	context	enviroment	setting	surroundings	environment
沼泽（地）	swamp
关闭	shut
协调	harmony
焦煤	coke
林场	timber
光束	ray
薪俸	salary
风趣的人	bundle
轻拍某物发出的声音	pat
突然的撕咬	snap
海水等的）层	region
保卫	safeguard	ward
一千美元	grand
奇特性	curiosity
高尔夫球运动	golf
神甫	priest
同盟国	ally
空缺的职位	opening
蕴含	implication
背后操纵的势力	wire
生存	survival	existence
反应	answer	reply	response
海洛因	heroin
（指甲下的）活肉	quick
蟹	crab
倒塌	breakdown
支撑	support
数量	amount	quantity
呼吁	appeal
（电视或广播节目的）女主持人	hostess
[计]检索	retrieve
呼吸	breath	wind
燃烧物	fire
出席率	attendance
耐药性	tolerance
霍克	hawk
（人生的）旅程	orbit
防护	security
地质学	geology
阻止	arrest
有文化	literacy
交往	commerce	conversation	intercourse
回答	answer	reply	response
意见	belief	comment	esteem	judgement	mind	notion	opinion	sentiment	suggestion	verdict	viewpoint
农业	agriculture
饮用后能使人精力充沛地从事竞选活动）	fuel
地震	earthquake
母鸡	hen
木工刨	plane
奖学金	scholarship
童年	childhood
铺过的路面	pavement
<口>傻子	stupid
需要的东西	need	want
私利	self
组织秘书	whip
企（事）业单位	enterprise
黄金时代	summer
软管	hose
相册	album
空中走廊	lane
小偷	sneak	thief
乳	milk
轮廓画法	outline
担保物	borrow
旋涡	spiral
境况	plight
长途电话费	toll
磨刀皮带	strap
鸟叫声	song
轻便帆布鞋（英式英语）	pump
司机	driver	operator
军官	officer
律契约	deed
人生	life
侦探	detective
镇长	mayor
异议	difficulty	objection
（人员、资金或地方的）富余的部份	slack
年代	date	era
升起	hoist
公事包	briefcase
馅饼	pie
剪下的东西	shear
蜡烛	candle
游戏	game	play	sport
法学家	lawyer
（学会等的）会议记录	transaction
正片	positive
自杀行为	suicide
财产目录的编制	inventory
长老	elder
长者	better
十八的记号	eighteen
尊严	dignity
图书管理员	librarian
物质	matter	substance
其时	meantime	meanwhile
状态	condition	feather	lie	position	shape	status
综合推理	synthesis
确定性	certainty
拂晓	dawn
登记	catalog	entry	register
见证人	witness
心脏	heart
母音	vowel
耐心	patience
司令部	command	headquarters
大使的职务（地位）	embassy
政治分肥	pork
真理	truth	true
转折点	crisis	hinge
焦虑	anxiety	sweat
拼法	spelling
贮藏室	closet
头等	first
武器装备	hardware
断裂	fracture
红衣服	red
傻笑	giggle
箱子	bin	chest
议题	question
（捕捉动物的）夹子	trap
浪漫思想[行为]	romantic
（思想、观点、文章主题等的）表现	statement
疼痛	bite	smart	ache
一品脱的量器或容器	pint
会所	club	hall
延伸	stretch	sweep
古时	old
笑话	joke	funny
人造喷泉	fountain
二中择一	alternative
符合行为准则的行为（或举止）	discipline
自然	nature
灰泥	plaster
说明	comment	why	explanation
透镜	lens	perspective
耐性	patience
眼力	eyesight
大理石等的）纹理	grain
[物]动量	momentum
果汁饮料	crush
一小绺胡须	imperial
双人床	twin
引以为傲的东西	boast
便利	convenience	accommodation
击穿	yield
昼	daytime
令人恐惧的事物	dread
入射角	incidence
手掌	palm
影象的清晰度	focus
〈口〉不安	flap
空位	void
猛然关闭的声音	slam
高速交通工具	rapid
宽松的上衣	blouse
倒数	reciprocal
热衷的事物	enthusiasm
知道决窍	rope
坯	blank
海拔高度	altitude
星	star
争论	argument	debate	difficulty	tangle
咒文	charm
友善的关系	friendship
（英国）保守党党员	conservative
大修道院的副院长	prior
友好的行为	kindness
客人	company	guest
[常作A-]整体	all
狭窄入口	jaw
[植]茎轴	axis
要求	call	demand	request	requirement	cry	instance
紊乱	chaos
[建]平屋顶	deck
会员身份	membership
喜悦	joy
好处	benefit	good	plus
富豪（阶级）	wealth
成立纪念日	birthday
（有特殊用途的）小房间	cabinet
埋葬…的地方	grave
（简单易记的）曲调	air
药可卡因	cocaine
蝴蝶	butterfly
马衔索	curb
恶性肿瘤	cancer
信头	heading
静居处	retreat
天平	balance
目录簿	catalog
卫生	health
心理学	psychology
飓风	hurricane
海上交通	navigation
专家	sharp	specialist	expert
吊车	crane
遮棚	shade
布头	list
干扰	interference
下倾	decline
商号	company	firm
道路	way
方针	course	track
酒窖	cellar
纸牌中的)黑桃	spade
敲击声	knock
[逻	category
钱	brass	money
闭锁	shut
不足额	deficiency	deficit	shortage
空气	atmosphere
盆	basin
学者	scholar	student	academic	philosopher
钩	hook
烧烤野餐	barbecue
[宗]免罪符	pardon
〈美〉冬季到南部做工的流动工人	tourist
老朋友	lad
盐	salt
钢	steel
盒	box
雇主	employer
悲剧的结局	catastrophe
盖	cap
防御地区	sector
现在	now	nowadays	present
冷冻机	fridge
地板	floor
针	needle
假设	hypothesis	tentative	assumption
水分	moisture
会社	fellowship
现场	scene
[体]假动作	fake
广大地域	extent
发生器	generator
手续费	commission
转化	translation
钱柜	till
花梗	stalk
[股票]现货	spot
拯救	salvation
膨胀	inflation
失业人数	unemployment
被浸泡的状态	steep
别针	pin
（在证券市场等）卖空的人	bear
女英雄	heroine
丝绸	silk
子弹	bullet
嬉戏	fun
请假条	excuse
[数学]根数	radical
反感	disgust
（自由）处置权	disposal
发抖	shiver	tremble
私通	intrigue
任职培训	orientation
大字标题	banner	headline
能读能写	literacy
笑柄	joke	scorn
褐色（或棕色）颜料（或染料）	brown
诗韵	metric
相似	analogy	resemblance
奇特的事物	odd
蜜（黄）色	honey
乘务员	steward
空中吊运车	trolley
[电学]（绝缘）套管	bush
激光	laser
涌流	current
远景	perspective
工程	project
（尤指基督教堂内的）牧师	clergy
中断	interrupt
（一）幕	act
突然的转向	jog
发表	daylight	publication
城镇	town
[信]接线台	switch
国际股票	international
经常费用	overhead
隐藏处	lie
口乱哄哄的热闹场面	circus
影响的范围	reach
曲解（意义）	violence
〈美俚〉反光镜	cheat
图象	visual
狭路	narrow
（关于某课题的）思考	reflection
星期三	Wednesday
尚待开发的领域	frontier
中间分子	intermediate
一阵风	blow
三角形	triangle
（疾病）侵袭	attack
极多	abundance
操心	bother
外甥	nephew
硬模	die
肥皂	soap
储藏	reservoir
财源	finance	purse
[生]选择	selection
部门	branch	category	department	desk	section	sector	division
预订	reservation
[动物学]节片	segment
遗失	loss
[军]通信兵	messenger
糕饼	cake
灯笼	lantern
冰状物	ice
疲乏	fatigue
桃树	peach
腐败、衰退的状态	decay
结束语	tag
敏感的人	sensible	sensitive
打扰	disturbance	interference
学会	college	academy	institute
节俭	saving	thrift
高层会议	summit
阿姨	aunt
捐助物	contribution
[植]芒	beard
皮肤	flesh	skin
文件套	jacket
走廊（一国领土通过他国境内的狭长地带）	corridor
垂直面	vertical
服务	employ	service
谅解	understanding
陈腔滥调的废话	jazz
块茎植物	bulb
[植]芽	button
民族	folk	nation
合意的人	goods
较优越者	better
晚上	night
同类	kind	party
一件商品（或物品）	item
下流场所	joint
豌豆类	pea
嗖嗖声	sing
申明	protest
说教	preach
（汽车轮的）制动器	shoe
[数学]比例（法）	proportion
皮夹子	wallet
零钱	cent	change
楼座	balcony
夜猫子	owl
[画]色调	tone
费	fare
美俚（披垂的）波型长发	waterfall
刑架	rack
句号	period
特价	special
回旋	whirl
消灭	destruction
侧面	phase	side	profile
（对付人的）计谋	trap
较好的人[事物]	superior
运动	campaign	game	motion	movement	sport	exercise
绷紧（身体部位的）肌肉	brace
宝匣	cassette
失球	turnover
眼睛	eye
民意调查	poll
饲料（尤指粗饲料）	feed
战友	comrade
（汽车等的）变速	shift
[计算机]网站	site
流通	currency
放荡的男人	rake
榴弹炮	cannon
捕获	capture
[逻辑学]内涵	comprehension
太空	space	void
升降车	cage
步调	pace	step
喇叭似的声音	trumpet
[生]族	tribe
烟气	fume
[数]百分法	percentage
奶牛	cow
良药	medicine
老生常谈	commonplace
审视	scan
（衣服的）腰身	waist
滑稽新闻	comic
专业服务费	fee
（线	jog
铁锹	spade
工作量	load
购买	purchase
[摄]底片	negative	plate
打扮	toilet
围脖	wrap
专门知识或技能	expertise
障碍栅栏）	obstacle
犯罪	crime	wrong
扩大	expansion	extension
包装纸	wrap
光线	beam	ray	shaft
（北美印第安人的）帐篷	lodge
修补	mend
沉积物	cake
打斗	struggle
机务员	operator
光纤	fiber
生活物质	provision
改革	reform	innovation
弹子游戏	marble
目录册	catalog
东亚人	oriental
往事	memory	past
甘蓝（洋白菜、卷心菜）	cabbage
大富翁	millionaire	money
小说	fiction
要道	artery
耸肩	shrug
洗衣板	paddle
（问题的）要点	knot
正方形	square
狂喜	transport
〈古〉出席	assistance
〈古〉猪	pork
美颜色	color
增大	wax
姑父	uncle
（讨论、考虑等的）问题	matter
威逼	hijack
物力	resource
季节	season	tide
污点	spot	stain
墩	pillar
激进分子	left	militant	radical
支撑物	support
君主	emperor	monarch	sovereign
薪水	money	pay	salary
漫画	cartoon
对抗	defy
灌木丛	brush
花瓶	vase
珍品	pearl
逆境	odds
号角	horn
游览	sightseeing	excursion
手迹	script
植物纤维	string
科研项目	project
瘟疫	pest	plague
[数]参数	parameter
失败者	failure
利润	gain	margin	profit
举	hoist
恶作剧	mischief	quiz	trick
主	lord
超出的时间	overtime
读书	read
符号	label	sign	symbol	expression
垛	stack
侦察舰	scout
（天体的）形成	evolution
记性	mind
有…轮子的汽车（或自行车等）	wheel
签证	visa
铜币	copper
野兽	beast	savage
一时的狂热	fever
体育馆	gymnasium
丢	throw
常量	constant
请愿	petition	plea
丝	silk
漆黑	eclipse
丛	cluster
（士兵穿的）工作服	fatigue
（通行税等的）征收权	toll
世	epoch
（因其生死言行而被基督教会追封的）圣人	saint
雇佣者	employer
卷边	bowing
一绺鬈发	curl
一阵（气味	puff
凳子	stool
警察	copper	police
高速交通网	rapid
桔色	orange
垫	pad
七	seven
外套	cloak	overcoat	wrap	coat
援助	assist	assistance
立放构件	upright
蔷薇（花）	rose
半径（距离）	radius
挽具	harness
招呼	greeting
耗尽	consumption
同时大量出现的事件	rash
公主	princess
控制力	command	grasp
籽粒	grain
[医]（传染病）接触人	contact
替代物	substitute
小题大做	production
电子琴	keyboard
[天]（日、月）食	eclipse
黄瓜	cucumber
（制作人造宝石的）铅质玻璃	paste
里德（人名）	read
比重	density
音色	speech
镶板	panel
感恩祈祷	Thanksgiving
版图	territory
注销	cancel
（浅底容器的）边缘	brim
（病人等的）生活规则	regime
能力所及	grasp
闪电	bolt	lightning
死伤者	casualty
冥想	meditation
深红色颜料	lake
臀部…的	hip
（细）绳	cord
宠儿	pet
收藏夹	favorite
（人与计算机的）人机对话	conversation
税	tax	toll
惨败	catastrophe
乳腺	breast
磨难	trial
财产等的）收入	revenue
允诺的东西	promise
信号	sign	signal
卷盘	reel
奶油色	cream
航海[飞行]日志	log
岁数	summer
规定	definition	provision	rule	institution
平野	champagne
一个人	one
水银	mercury
堇菜	violet
[用复数][法律]诉讼费	cost
（一）盘	coil
绝望	despair
训练	discipline	education	training	exercise
素质	timber
排行榜	chart
（滑车等的）通索孔	swallow
薄层	film
限额	allowance
感情	emotion	feeling	heart	sentiment	affect
（尤指金钱的）支出额	expenditure
巨大的事物	whale
植]轮	whirl
管子工	plumber
减号	minus
（英国）学院	college
英铁路货车	wagon
酒量大的人	tank
自责	guilt
主战派	hawk
唱片	disc	record	album
循环	circle	cycle	round
铁匠工场	forge
（船、飞机等的）左舷	port
[语]陈述语气	indicative
端详	gaze
大理石制品	marble
[宗]守护神	patron
邀请	invitation	invite
人文学科	humanity
常规	general
黏合（剂）	bond
精神错乱	complication
判断	estimate	judgement	judgement
守护神	angel
谷仓	barn	elevator
家务劳动	housework
主教（或大主教）教区	see
苦事	sour
[人名]斯洛特	slot
（事件等的）连续	stream
柏油	tar
带镜小粉盒	compact
怪想	fancy
文章	paper
定位于	fix
（动词的）语态	voice
含义是“东方的”(eastern)	Easter
评判员	judge
脖子	neck
黎明	dawn	daylight	light	morning	sunrise
畸形	monster
冰	ice
放映技师	projector
走向	trend
小建议	tip
揩布	cloth
入狱	prison
（包含人在内的）家眷	household
（光、色等的）斑点	splash
恶魔	monster
诗篇	verse
尖形器具	prick
铅版制版法	stereotype
有钩部分	hook
满足	content	enough	satisfaction
好名声	reputation
谦恭有礼	courtesy
战利品	conquest	prize
[棒]安全打	safety
秘密引线	wire
大学教授职位	chair
果皮	peel
有生之年	lifetime
警察部门	police
尖锐	edge
少数民族	minority
一连串的事	whirl
考验	test
十九世纪	eighteen
生气	anger	pet
操心的事	funeral
<美>毕业班学生	senior
临时旅客	transient
葡萄紫	grape
异国	abroad
塔	tower
重复的事物	repeat
帽舌	peak
[语]（形容词或副词的）比较级形式	comparative
传达	communication
延期	stay	extension
护卫队	guard
供奉	sacrifice
例外	exception
修正	compensation
反抗	rebellion
委派	assignment
社团	corporation	league	society	association
探索	grope	quest	research
棉被	quilt
[计]编辑软件	editor
波浪	wave
（利息等的）费率	rate
三十年代	thirty
生活信条	philosophy
班机	liner
作用	function	operation	part	purpose	role	action
约373克）	as
一套	tissue
“story”的变体	storey
〈俚〉龙须菜	grass
惨剧	tragedy
度假胜地	resort	resort
[天]北斗七星	plough
矿砂	ore
操作杆	lever
结构	design	formation	structure	texture
哨声	whistle
[数]被除数opp.divisor	dividend
接连	succession
但是	but
结果	consequence	event	harvest	offspring	outcome	produce	product	result	resultant
逆流	setback
组织	frame	framework	machinery	organization	outfit
羡慕	envy
上流社会	society
保险箱	safe
现状	status
窗帘	curtain
指南针	compass
（汽车或其他机器的）空挡位置	neutral
[天]黄纬	latitude
化学	chemistry
[动]寄生虫	guest
（构成）要素	ingredient
胶带	tape
精确（性）	accuracy
引退期间	retreat
大调	major
恩义	gratitude
推理	inference
爆破工	fireman
募捐	collection
学校	school
放荡	riot
脂肪酸盐	soap
枪	gun	spear
接近	access	approach
俚电子流	rain
污斑	blur
美玉蜀黍	corn
站	station	station
重要人士	swell
甜味	sweet
[天]水星	mercury
强烈的仇恨或厌恶	hate
化硅	silicon
注射	shot
生殖	generation	get
混合物	blend	composite
土地	ground	land	soil	acre
恢复开始时姿势	recover
疗法	cure	therapy
修理工作	repair
（木材	grain	scarf
Wheels汽车	wheel
滑翔	glide
英支票	cheque
茶	tea
牛棚	stable
责任心	responsibility
低语	whisper
（机械）结构	mechanism
凌乱	disorder
<口>呕吐物	sick
题名	heading
丢脸	disgrace
（旅店或寄宿舍的）女店主	landlady
古训	wisdom
檀条	summer
保护手段	hedge
[非正式用语]眼部青肿	mouse
健全	integrity
污泥	dirt
[生]遗传（密）码	code
皇权	purple
双	couple
雌性动物	female
（附抽屉及活动写字台的）书桌	bureau
（门、墙等上面的）嵌板	panel
无实用价值的东西	toy
（键盘上的）控制键	control
特使	ambassador
[医]探针	probe
建议	counsel	proposal	proposition	suggestion	advice	instance
议会	parliament
磨光	polish
迅速（办理）	expedition
广告	bill
饭店	hotel	restaurant
威信	prestige
塞子	plug	tap	tent
添加	more
（数量或水平的）增加	rise
[计]分层	hierarchy
农田	farm
岗位	post
有趣的事情	comedy
叉（挖掘用的园艺工具）	fork
伤风	cold
（政府机关等的）秘书官	secretary
加强	reinforce
涂盖层	overlap
首字母	initial
迅速的传播、生长或发展	epidemic
阶段	grade	phase	stage
（对神等的）敬畏	fear
一大堆	mountain
（天地未出现的）浑沌世界	chaos
thepoor贫困者	poor
上升高度	soar
圆盘	disc
专用地	reservation
球棍	stick
监狱	gaol	prison
名人	celebrity	lion	notable	personality
切片	cut
基地	base
野草	weed
汽车）	shuttle
烙铁	iron
照射器	lamp
[音乐]声乐作品	vocal
肃静	silence
惊跳	startle
失业状况	unemployment
辩解	excuse	explanation
个人的舒适或利益	convenience
背部	back
相交	overlap	intersection
（地下由黏土、岩石等构成的）地层	bed
超常的学生	exceptional
头巾	wrap
习语中保存的旧词	fossil
值班	watch
实情	fact
年	year
精通	proficiency
幸存	survival
内科医生	physician
[逻]反对命题	contrary
丈夫	husband
主力（或正式）队员	regular
罪恶	crime	evil	guilt	sin
覆盖物	cloak	cover	overlap	veil
〈口〉大好人	brick
印记	stamp	impress	impression
钥匙	key
谈论	remark
日出之处	orient
紧张	electricity	nightmare	stretch	tension
知名人士	celebrity
证件	document
常例	ordinary
兴趣	hobby	interest
相关联的人	correlate
寄存	deposit
培养	education	training
精确度	precision
滑稽人物	comic	funny
听筒	phone
短上衣	blouse	jacket
志愿者	volunteer
新入会的人	initiate
食谱	recipe
（农舍式的）小别墅	cottage
山脊	brow	ridge
山脉	mountain	ridge
八人（或物）一组	eight
蚕丝	silk
煤	coal
同伙	partner
村舍	cottage
