abdomen	n.腹，下腹(胸部到腿部的部分)
abound	vi.大量存在；(in，with)充满，富于
abundance	n.丰富，充裕，大量
abundant	a.大量(充足)的；(in)丰富(富裕)的
accuse	vt.控告，指责 vi.指控，指责
admission	n.允许进入；承认；入场费，入会费，入场券
adore	vt.崇拜,敬慕,爱慕；非常喜欢
advent	n.(重要事件等的)到来，来临
adventure	n.冒险，冒险活动，奇遇 vt.大胆进行
adverb	n.副词 a.副词的
adverse	a.逆的，相反的；敌对的；不利的；有害的
advisable	a.可取的，适当的，明智的
aerial	a.(在或来自)空中的，航空的 n.天线
aeroplane	n.(airplane)(英)飞机
aesthetic	a.(esthetic)美学的，艺术的；审美的
affair	n.[pl.]事务；事情(件)；(个人的)事
agitate	v.摇动(液体)；使焦虑不安；困扰；鼓动
agony	n.(精神或肉体的)极大痛苦，创伤
Aid	n.援助，救护；助手，辅助物 vi.援助，救援
Aim	n.目的；瞄准 vi.(at)目的在于 vt.把…瞄准
Aisle	n.(教堂、教室、戏院等里的)过道，通道
Alive	a.活着的；存在的；活跃的；(to)敏感的
altogether	ad.完全，总之，全部地；总共；总而言之
amend	vt.修改，修订，改进
amiable	a.和蔼可亲的，友善的，亲切的
ample	a.充分的，富裕的；宽敞的，宽大的
ancient	a.古代的，古老的，古式的
anecdote	n.轶事，趣闻，短故事
anguish	n.(尤指心灵上的)极度痛苦，烦恼
annoy	vt.使恼怒，使生气；打扰 vi.招人讨厌
antenna	n.(无线电或电视的)天线
antique	a.古式的，过时的　n.有价值的古物，古董
appal	v.使惊骇，使恐怖
apt	a.恰当的，适当的；易于…的，有…倾向的
arrogant	a.傲慢的，自大的
articulate	a.善于表达的；有关节相连的 v.清楚地讲话
artificial	a.人工的，人造的，人为的；虚伪的，做作的
ash	n.灰，灰末；(pl.)骨灰；(pl.)废墟
ashore	ad.上岸；在岸上，向岸上
aspire	vi.(to，after)渴望，追求，有志于
assimilate	vt.吸收，消化；使同化 vi.被吸收；被同化
assist	vt.协助，帮助，促进 vi.帮忙，参加
audit	v.审计；查帐；核对；旁听
auditorium	n.观众席，听众席；会堂，礼堂
aural	a.听觉的，听力的
authentic	a.真的，真正的；可靠的，可信的，有根据的
automation	n.自动，自动化，自动操作
autonomy	n.自治，自治权；
avert	v.防止，避免 ；转移(目光、注意力等)
aviation	n.航空，航空学；飞机制造业
award	vt.授予,给予；判定 n.奖,奖金；仲裁
aware	a.知道的，意识到的；
awe	n.敬畏，惊惧vt.使敬畏，使惊惧
awkward	a.笨拙的；尴尬的；使用不便的；难处理的
badge	n.徽章,像章；标记；象征；记号
baggage	n.行李
bait	n.饵，引诱物 vt.用饵引诱；折磨，奚落
balcony	n.阳台；(电影院等的)楼厅，楼座
bald	a.秃的,秃头的
ballot	n.(不记名)投票；投票总数；投票权 vi.投票
barbecue	n.烤肉；烤肉用的台架 vt.炙烤(肉等)
barber	n.理发师
bare	a.赤裸的,空的;稀少的,仅有的 v.露出,暴露
barely	ad.赤裸裸地,无遮蔽地;仅仅,勉强,几乎没有
basin	n.盆,脸盆;内海,盆地
bearing	n.轴承；忍受；关系，影响；举止；方向
behave	v.举止,举动,表现;运转,开动
belt	n.(皮)带,腰带;地带
besides	ad.此外；并且 prep.于…之外；除…以外
bet	v.赌,打赌 n.打赌,赌注
biscuit	n.饼干,点心
bitter	a.(有)苦(味)的;痛苦的,厉害的
blame	v.责备;怪,把…归咎于 n.责任,过错;责备
blast	n.一阵(风);爆炸冲击波;管乐器声 v.爆炸
blunder	v.(因无知等而)犯大错;踉踉跄跄地走 n.大错
boil	v.(使)沸腾,煮(沸)
boom	v.迅速发展,兴旺;发出隆隆声
bowel	n.肠；［pl.］内部，深处
bowl	n.碗(状物),钵
bowling	n.保龄球运动
bracket	n.(方)括号
brass	n.黄铜,铜器
breach	n.违反，不履行；破裂 vt.冲破，攻破
bread	n.面包
breast	n.胸膛,乳房
breed	v.(使)繁殖,生殖;产生;教养,抚养 n.品种
bribe	n.贿赂 v.向…行贿,买通
bride	n.新娘
brief	a.简短的,简洁的 v.简短介绍,简要汇报
brim	n.边缘,帽沿
brisk	a.轻快的;生气勃勃的;兴隆的
brittle	a.易碎的；脆弱的；冷淡的；(声音)尖利的
brochure	n.小册子
bronze	n.青铜；青铜色，古铜色；青铜制品，铜牌
brook	n.小溪vt.[常用于否定句或疑问句]容忍
broom	n.扫帚
brow	n.眉(毛);额
brown	n./a.褐色(的),棕色(的)
browse	vi.随意翻阅，浏览；(牛、羊等)吃草
bruise	n.青肿，挫伤；伤痕vt.打青；挫伤
bud	n.芽,花苞 v.发芽,含苞欲放
buffet	n.自助餐
bulb	n.灯泡,球状物
bulk	n.体积,容积;主体,大批,大量,大块
bull	n.公牛
bulletin	n.公报,公告,告示
bully	n.恃强欺弱者，小流氓 vt.威胁，欺侮
bump	v.(against,into)碰;颠簸着前进 n.碰撞
burglar	n.(入室行窃的)盗贼
burst	v.爆裂,炸破;突然发生 n.突然破裂,爆发
bury	v.埋(葬),安葬;埋藏,遮盖
bush	n.灌木(丛)
butcher	n.屠夫,卖肉者
cab	n.出租车，出租马车；驾驶室 vi.乘出租马车
cabbage	n.洋白菜,卷心菜
cafeteria	n.自助食堂
cage	n.鸟笼
calcium	n.钙(化学符号Ca)
camera	n.照相机,摄影机
camp	n.野营,营地;帐篷,阵营 v.设营,宿营
campus	n.(大学)校园
canal	n.运河;(沟)渠
candle	n.蜡烛
canoe	n.独木舟,小游艇
canteen	n.(工厂、办公室等)食堂或小卖部
cape	n.海角，岬；披肩，短披风
captain	n.首领,队长;船长;上尉 v.做…的首领,指挥
captive	n.俘虏 a.被俘虏的,被监禁的
carbohydrate	n.碳水化合物; 糖类；(plural)淀粉质或糖类
carbon	n.碳
cardinal	n.(天主教的)红衣主教 a.首要的，基本的
carpet	n.地毯
cater	vi.(for/to)满足,迎合;(for)提供饮食及服务
cathedral	n.大教堂
Catholic	a.天主教的 n.天主教徒
cement	n.水泥;胶泥,胶接剂 v.胶合;巩固,加强
cemetery	n.坟墓，墓地，坟场
census	n.人口普查(调查)
cent	n.分(币);百 per cent百分之
cereal	n.加工而成的谷类食物；谷类植物，谷物
chalk	n.粉笔,白垩
chamber	n.房间，室；会议室；议院；(动物体内)腔室
chancellor	n.(英)大臣；法官；(德、奥)总理；大学校长
chap	n./v.(皮肤)变粗糙；发痛；n.小伙子
charter	v.租船,租车,租用飞机；n.宪章，特许状
cheat	v.欺骗;作弊 n.骗子;欺诈,欺骗行为
cheek	n.面颊,脸
cheer	v.(使)振奋,(使)高兴 v./n.喝彩,欢呼
chef	n.(餐馆等的)厨师长，厨师
cheque	n.(check)支票,空白支票;总收入
cherish	vt.抱有，怀有(希望等)；爱护，抚育；珍爱
chest	n.胸腔,胸膛;箱,柜
chill	n.寒冷,寒气,寒战 v.使寒冷
chimney	n.烟囱
chin	n.下巴,颏
choke	v.窒息,噎住;闷塞,堵塞,阻塞
chorus	n.合唱队;合唱 v.异口同声地说,随声附和
Christ	n.基督，救世主，耶稣
Christian	n.基督教徒 a.基督教徒的
circumference	n.圆周,周围
citizen	n.公民;市民,居民
clause	n.(正式文件或法律文件的)条款;从句,分句
claw	n.爪,脚爪
clay	n.粘土,泥土
clergy	n.[总称]牧师，神职人员
clerk	n.职员,办事员;店员
clinic	n.诊所
cloak	n.斗蓬，披风；掩饰，幌子vt.掩盖，掩饰
clumsy	a.笨拙的,愚笨的
coal	n.煤,煤块
coalition	n.结合体，同盟；结合，联合
coarse	a.粗糙的,粗劣的;粗鲁的,粗俗的
coast	n.海岸,海滨
coat	n.上衣，外套；表皮；层,覆盖物 v.涂(盖)上
coherent	a.一致的，协调的；(话语等)条理清楚的
cohesive	a.粘合性的，有结合力的
coil	v.卷,盘绕 n.(一)卷,(一)圈;线圈,绕组
coke	n.焦炭；可口可乐（COCA-COLA）的缩写
collar	n.衣领;环状物
collide	vi.[with]互撞，碰撞；冲突，抵触
colonel	n.(陆军)上校
colonial	a.殖民地的，关于殖民的 n.殖民地居民
colony	n.殖民地；侨民；聚居区；(动植物的)群体
comic	a.喜剧的，滑稽的n.连环漫画杂志；喜剧演员
commence	vt.开始 vi.获得学位
commend	v.称赞，表扬：委托保管；推荐
commerce	n.商业，贸易；交际，交往
commercial	a.商业的；商务的；可获利的 n.广告节目
commission	n.委员会;委任,委托(书),代办;佣金,手续费
commit	v.把…交托给,提交;犯(错误),干(坏事)
commonplace	a.普通的，平庸的n.寻常的事物，平庸的东西
commonwealth	n.共和国,联邦,共同体
communism	n.共产主义
compartment	n.卧车包房,(客车车厢内的)隔间;分隔的空间
compassion	n.同情；怜悯(for)
compatible	a.能和睦相处的,合得来的;兼容的
compensation	n.补偿(或赔偿)的款物；补偿，赔偿
complement	n.补足物，船上的定员；补语 vt.补充，补足
compliment	n.(pl.)问候,致意 n./v.称赞,恭维
comply	v.(with)遵照，照做，应允；顺从，服从
composite	a.混合成的，综合成的n.合成物，复合材料
composition	n.作品,作文,乐曲;作曲;结构,组成,成分
compound	n.混合物,化合物 a.混合的,化合的；vt.混合
comprehend	vt.理解，领会；包含，包括
compress	vt.压紧，压缩；(把思想、文字等)浓缩
comprise	vt.包含，包括，由...组成；构成，组成
compromise	n.妥协，折衷vi.妥协vt.危及，放弃(原则等)
compulsory	a.必须做的，强制性的，(课程)必修的
comrade	n.同志,同事,同伴,朋友
conceal	v.隐藏,隐瞒,隐蔽
concentrate	v.(on)集中,专心;浓缩 n.浓缩物
concentration	n.专心，专注；集中，集结；浓度
concise	a.简明的,简洁的
concrete	a.具体的,实质性的n.混凝土v.用混凝土修筑
condemn	v.谴责,指责;判刑,宣告有罪
condense	v.(使)冷凝，(使)凝结；浓缩，压缩，简缩
confer	v.商讨；授予，颁给(勋衔，学位等)
conference	n.(正式)会议；讨论，商谈
confess	v.供认，承认，坦白，忏悔
confine	vt.限制；使不外出，禁闭n.[pl.]界限，范围
conspicuous	a.显眼的,明显的
constitute	vt.组成，构成，形成；设立，建立，任命
constitution	n.构成,构造,组成(方式),成分;体格;宪法
contaminate	v.弄污,弄脏,毒害,传染,染污
contempt	n.轻视，藐视；受辱，丢脸
contend	v.竞争,斗争;坚决主张
continent	n.大陆,洲
contrary	a.(to)相反的,矛盾的 n.反对,矛盾;相反
contrast	n.对比，对照 vi.形成对比 vt.把…与…对比
convention	n.大会,会议;惯例,常规,习俗;公约,协定
conventional	a.惯例的,常规的
conversely	ad.相反地
conversion	n.转变，转换；信仰的改变；
cope	v.(with)竞争,对抗;(with)对付,妥善处理
copper	n.铜;铜币,铜制器
cord	n.绳,索
cordial	a.诚恳的,亲切的,热诚的
corridor	n.走廊,通路
corrode	v.(受)腐蚀,侵蚀
corrupt	v.贿赂,收买 a.腐败的,贪污的
cosy	a.暖和舒服的；舒适的 [反]uncomfortable
cottage	n.村舍,小屋,别墅
cotton	n.棉花;棉线,棉纱;棉制品
cough	v./n.咳嗽
course	n.课程,教程;过程,进程;路程,路线;一道菜
courtesy	n.谦恭有礼;有礼貌的举止(或言词)
cousin	n.堂(或表)兄弟,堂(或表)姐妹
cow	n.母牛,奶牛
crab	n.螃蟹,蟹肉
cradle	n.摇篮;发源地
crane	n.起重机,鹤
crawl	v./n.爬行,蠕动;缓慢(的)行进
credential	n.凭证，(pl.)国书，证明书
crew	n.全体船员,全体乘务员
cricket	n.板球;蟋蟀
cripple	n.跛子,残疾人 v.使跛,使残疾
crisp	a.脆的,易碎的;简明扼要的；（空气）清爽的
crude	a.天然的,未加工的;未熟的;粗鲁的,粗野的
cruel	a.残忍的,残酷的
cruise	v.巡航；以节省燃料的速度前进 n.乘船巡游
crush	n./v.压碎,压坏 v.压服,压垮
crust	n.外皮,壳;地壳
cucumber	n.黄瓜
cue	暗示, 提示, 球杆
cunning	a./n.狡猾(的),狡诈(的)
curb	n.路边，场外证券市场，vt.制止，抑制
cure	v.(of)治愈,医治;矫正 n.治愈,痊愈;良药
curl	v.(使)卷曲,蜷缩 n.卷发;卷曲状;卷曲物
curriculum	n.(pl.curricula)课程,(学校等的)全部课程
curse	n.诅咒,咒语,祸因 vt.诅咒,咒骂,使受罪
curtain	n.窗帘,门帘;幕(布);结束； vt遮掩
curve	n.曲线,弯曲(物) v.弄弯,成曲形
cushion	n.垫子,软垫 vt.装垫子;缓和,减轻;
cyberspace	n.虚拟信息空间;网络空间
dairy	n.牛奶场,奶店
damn	int.该死 vt.遣责；使失败 a.十足的 ad.极
damp	n.潮湿 a.潮湿的 vt.使潮湿;使衰减
danger	n.危险;威胁;危险事物
darling	n.心爱的人,亲爱的
dash	v./n.冲,猛冲,突进 n.破折号
deaf	a.聋的;不愿听的
dean	n.(大学)院长;主持牧师; (基督教)教长
decay	v./n.腐朽,腐烂;衰减,衰退
deceit	n.欺骗,欺骗行为
decrease	n.减少,减小;减少量 v.减少,变少,降低
deduce	vt.(from)演绎,推断,推论
deduct	vt.扣除;演绎(推理)
deed	n.行为,行动;功绩,事迹;证书；契据
deem	v.认为,相信
defeat	n.击败,战胜,失败 v.击败,战胜;使失败
defy	v.(公然)违抗,反抗;蔑视
deliberate	a.深思熟虑的,故意的 vt.研讨,商讨
delicate	a.纤弱的;精致的;微妙的;灵敏的
delight	n.快乐,高兴 v.(使)高兴,(使)欣喜
dental	a.牙齿的；牙科(用)的
dentist	n.牙医
deprive	vt.剥夺,夺去,使丧失
deputy	n.代理人,代表 a.副的,代理的
designate	v.指明,指出;任命,指派
desolate	a.荒凉的;孤独的 v.使荒芜
despair	n.绝望;失望;令人失望的人(事物)v.绝望
despatch	n./v.(dispatch)派遣;发送 n.急件;新闻报道
despise	v.轻视,蔑视
despite	prep.不管,不顾
dessert	n.正餐后的水果或甜食
detain	v.耽搁;扣押,拘留
detect	v.察觉,发觉,侦察,探测
deviate	v.(from)背离,偏离
devil	n.魔鬼
dew	n.露水
diagnose	vt.诊断(疾病)；判断(问题)
dial	n.钟(表)面,刻度盘,拨号盘 v.拨号,打电话
dialect	n.方言
diameter	n.直径
diary	n.日记,日记簿
dictate	v.口授;(使)听写;指令,指示,命令;
dictation	n.听写,口述;命令
diffuse	v.扩散;传播 a.(文章等)冗长的,漫无边际的
digest	vt.消化；领会，融会贯通 n.文摘，摘要
dignity	n.(举止,态度等的)庄严,端庄;尊贵,高贵
dilute	vt.稀释，冲淡 a.稀释的，冲淡的
dim	a.暗淡的,模糊的
diminish	v.缩小,减少,递减
dine	v.吃饭,进餐
dip	v./n.浸,蘸
diploma	n.毕业文凭,学位证书
diplomatic	a.外交的,从事外交的;策略的,有手腕的
dirt	n.污物,污垢
disc	n.(disk)圆盘,圆面,盘状物
discern	v.认出,发现;辨别,识别
discourse	n.论文;演说;谈话;话语 vi.讲述,著述
discreet	a.(言行)谨慎的；慎重的；有判断力的
discrepancy	n.相差;差异;矛盾;
disease	n.疾病
disgrace	n.失宠,耻辱 v.使失宠;玷辱,使蒙羞
disguise	n./v.假装,伪装
disgust	n.厌恶,恶心 v.使厌恶
dismay	n./v.(使)沮丧;(使)惊慌;(使)失望,(使)绝望
disperse	v.(使)分散;(使)散开;疏散
disposal	n.处理,处置;布置,安排
dispose	v.(of)处理,处置;(for)布置,安排
disposition	n.排列,部署;性格倾向;倾向,意向
disrupt	vt.使混乱，使崩溃，使分裂，使瓦解
dissipate	v.驱散;(使云、雾、疑虑等)消散;挥霍
dissolve	v.(使)溶解,(使)融化;解散,取消
distant	a.远的;遥远的;疏远的;不亲近的
distill	vt.蒸馏，用蒸馏法提取；吸取，提炼
distract	v.分散;使分心;打扰;使心情烦乱
distress	n.苦恼;危难;不幸 v.使苦恼
district	n.地区,行政区;美国各州的众议院选区
ditch	n.沟,沟渠,水沟
divert	vt.使转向，使改道；转移(注意力)；使娱乐
divine	a.神的，神授的，天赐的；极好的，极美的
dizzy	a.头晕目眩的,眩晕的;(可能)使人头晕的
dock	n.船坞,码头
doctorate	n.博士学位;博士头衔
doll	n.玩偶,玩具娃娃
donate	vt.损赠(金钱等);赠予
donkey	n.驴子；蠢人；顽固的人
doom	n.厄运,劫数 v.注定,命定
doorway	n.门口
dorm	n.(dormitory)［美］［口］宿舍
dose	n.剂量,一服,一剂 v.(给…)服药
dove	n.鸽子
drain	n.排水沟,阴沟;消耗,负担 v.排去,放干
drastic	a.激烈的,严厉的;(药性等)猛烈的
dread	v./n.恐惧,担心
dress	n.服装,童装,女装 v.穿衣,打扮
drill	v.练习;操练;钻孔 n.操练;练习;钻孔(机)
drip	v.滴下,漏水 n.滴,水滴,点滴
drought	n.旱灾,干旱
drown	v.溺死,淹没
drum	n.鼓;圆桶
duck	n.鸭,鸭肉 v.迅速俯身;快速低头;躲避
dull	a.单调的;迟钝的,愚笨的;不锋利的
dumb	a.哑的,无言的
dusk	n.薄暮,黄昏
dust	n.灰尘,尘土 v.拂,掸
dwarf	n.矮子，侏儒，矮小的动植物 vt.使…矮小
dye	n.染料 v.染,染色
dynasty	n.王朝,朝代
eagle	n.鹰
ebb	vi.衰退，减退 n.处于低潮，处于衰退状态
ego	n.自我，自负，利已主义；(心理学)自我意识
endurance	n.忍耐(力),持久(力),耐久(性)
enquire	v.(inquire)询问,打听;调查;查问
enroll	v.(enrol)招收;登记;入学;参军;成为会员
entail	vt.使承担;需要;把(疾病等)遗传给;限定
entrepreneur	n.[法]企业家, 主办人
entry	n.进入,入口;通道;记载,条目
epoch	n.新纪元;时代;时期;【地质】世,纪,期
era	n.时代,年代,阶段,纪元
erosion	n.腐蚀,磨损;削弱,减少
erroneous	a.错误的,不正确的
erupt	v.(尤指火山)爆发
escalate	v.(使)逐步增长(或发展)，(使)逐步升级
esteem	n.尊敬，尊重 vt.尊重，敬重；把…看作
eternal	n.永久的,永恒的
evacuate	vt.撤离，疏散，排泄，剥夺
evade	vt.逃避，回避；避开，躲避
evaporate	v.蒸发,挥发;沉淀;发射;消失
exaggerate	v.夸大,夸张
excursion	n.短途旅行,游览;离题;[物理]偏移,漂移
exemplify	v.举例证明;示范;作...的范例[榜样]
exempt	a.免除的 v.免除 n.免税者;被免除义务者
exert	v.尽(力),施加(压力等),努力
exile	n.流放；被流放者 vt.流放，放逐，把…充军
expedition	n.远征(队),探险(队)
expel	v.把…开除;驱逐;排出;发射
explode	v.(使)爆炸,(使)爆发
exploit	v.开拓;开发;剥削 n.功绩[勋];业绩
expose	v.(to)使暴露,受到;使曝光
exposure	n.暴露,揭露;方向;陈列;遗弃;照射量
exquisite	a.优美的，高雅的，精致的；剧烈的，异常的
exterior	a.外部的,外面的 n.外部
fable	n.寓言
faint	a.微弱的;不明显的;暗淡的 n./v.昏倒;昏晕
faith	n.信任,信用;信仰,信条
faithful	a.守信的,忠实的,如实的,可靠的
fame	n.名声;名望;传说 vt使出名;传扬…的名
fantasy	n.幻想，空想；空想的产物，幻想作品
fare	n.车费,船费;伙食;乘客 v.过活;进展;经营
fascinate	v.迷住,强烈吸引
fatigue	n./v.(使)疲劳
faulty	a.有错误的，有缺点的，不完善的
feast	n.节日;宴会
feeble	a.虚弱的,无力的
feed	v.(on,with)喂养,饲养;(with)向…供给
fellow	n.人,家伙;伙伴,同事 a.同样的,同事的
feminine	a.女性的;娇柔的
ferry	n.摆渡;渡船;渡口v.摆渡;渡运(人,车或物等)
feudal	a.封建的;封地的;领地的
fever	n.发热,狂热
fiction	n.虚构,编造;小说
finger	n.手指;指状物;指针
fire	n.火；火灾，失火；炉火 vi.开火 vt.放(枪)
fireplace	n.壁炉
fist	n.拳头 vt.用拳头打；紧握
flame	n.火焰,火苗;热情;光辉 v.发火焰,燃烧
flap	n.垂下物,帽沿,袋盖 n./v.拍打,拍动
flare	v./n.闪耀,闪烁
flash	n./a.闪光(的) v.发闪光,闪亮;闪现
flavor	n.(flavour)情味;风味;滋味 v.给…调味
flaw	n.裂缝;缺陷 v.使破裂;使有缺陷
flee	v.逃走;逃避
fleet	n.舰队,船队
flesh	n.肉,肌肉
flight	n.飞翔,飞行;航班;航程;逃跑;楼梯的一段
fling	v.(用力地)扔,抛,丢
flock	n.(一)群,(禽,畜等的)群;大量 v.群集,成群
flow	v.流,流动 n.流量,流速
flu	n.(influenza)流行性感冒
foam	v./n.泡沫,起泡沫
fog	n.雾气，雾 v.以雾笼罩，被雾笼罩
fond	a.(of)喜爱的,爱好的
footstep	n.脚步(声),足迹
fore	ad.在前面 a.先前的；在前部的 n.前部
forecast	v./n.预测,预报
forehead	n.前额;(任何事物的)前部
foremost	a.最先的;最初的; 主要的 ad.首要地
foresee	v.预见,预知
forge	v.锻造,伪造 n.锻工车间;锻炉
formation	n.形成;构成;组织;构造;编制;塑造
formidable	a.强大的;令人敬畏的;可怕的;艰难的
forth	ad.向前；向外，往外
forthcoming	a.即将到来的;准备好的;乐意帮助的;n.来临
fortnight	n.两星期
fortunate	a.幸运的,侥幸的
forty	num./a.四十 pron.四十(个，只...)
forum	n.论坛,讨论会
fossil	n.化石
foster	vt.养育;收养;怀抱;鼓励 a.收养的 n.养育者
foul	a.污秽的;邪恶的 v.弄脏;妨害;犯规 n.犯规
fountain	n.泉水,喷泉,源泉
fraction	n.碎片,小部分,一点儿;分数
fracture	n.裂缝(痕);骨折 v.(使)断裂,(使)折断
fragile	a.易碎的，脆的，易损坏的；虚弱的，脆弱的
fragrant	a.香的;芬芳的
fraud	n.欺诈，诈骗；欺骗(行为)；骗子；假货
freight	n.货物,货运,运费
friction	n.磨擦,摩擦力
fridge	n.(refrigerator的略语)冰箱
fright	n.恐怖
frighten	v.使惊恐
fringe	n.边缘；(窗帘)缘饰；额前垂发 vt.饰…的边
frost	n.霜,霜冻,严寒
frustrate	vt.挫败,阻挠,使灰心
fume	n.(浓烈或难闻的）烟，气，汽
funeral	n.丧葬,葬礼
fur	n.毛,毛皮
furious	a.狂怒的,狂暴的,猛烈的
furnace	n.炉子,熔炉
furnish	v.供应,提供;装备,布置
furniture	n.家具
further	ad./a.更远,更往前;进一步 v.促进,增进
fuse	n.保险丝,导火线,引信 v.熔化,熔合
fuss	n./v.忙乱,大惊小怪
futile	a.无效的，无用的，无希望的
gallery	n.长廊,画廊,美术馆
gallon	n.加仑
gallop	v./n.奔驰,飞奔
gang	n.一帮,一群,一伙
gaol	n.(jail)监狱；(不加冠词)监禁 vt.使…坐牢
garage	n.车库,飞机库;修车厂
garlic	n.蒜，大蒜粉
garment	n.(一件)衣服
gentle	a.和蔼的,文雅的,有礼貌的
gently	ad.文雅地,有礼貌地;轻轻地
glimpse	n./v.一瞥,瞥见
goat	n.山羊
goodby	int.(goodbye)再见
goose	n.(pl.geese)鹅,雌鹅,鹅肉
gown	n.长袍，特殊场合穿的长服
grace	n.优美,文雅;恩惠,恩泽;宽限,缓刑;感恩祷告
graceful	a.优美的,文雅的,大方的
gracious	a.亲切的,客气的;宽厚的,仁慈的
grade	n.等级,级别;年级;分数 v.分等,分级
grain	n.谷物,谷类;颗粒,细粒
gramme	n.(gram)克
grammar	n.语法,语法书
gratitude	n.感激,感谢
graze	vi.吃青草 vt.放牧;擦伤;掠过 .n.擦伤(处)
greet	v.致敬,敬意,迎接;扑(鼻),入(耳),触(目)
greeting	n.问候,致敬
grey	n./a.(gray)灰色(的)
grim	a.严酷的，令人害怕的；不愉快的，讨厌的
grin	n./vi.露齿而笑，咧嘴一笑
grip	v./n.紧握,抓紧;掌握
grope	n./v.摸索,探索
gut	n.[pl.]胆量；内脏a.本能的vt.取出内脏
gymnasium	n.(gym)体育馆，健身房
hail	v.下雹;欢呼,欢迎 n.雹
hall	n.礼堂,会堂,办公大楼,门厅
halt	n.止步,停步,停止前进 v.止步,(使)停止
ham	n.火腿
hammer	n.铁锤,槌,榔头 v.锤击,敲打
hamper	v.妨碍,阻碍,牵制
handicap	v.妨碍 n.(身体或智力方面的)缺陷;不利条件
handkerchief	n.手帕
handy	a.手边的,近便的;方便的
harassment	n.骚扰，扰乱；烦恼，烦乱
harbor	n.(harbour)海港;避难所 v.隐匿,窝藏
harmony	n.协调,和谐;融洽
harsh	a.粗糙的；(声音)刺耳的；苛刻的，严酷的
hatch	v.孵,孵出;策划,图谋 n.舱口,小门
hatred	n.憎恨,憎恶,怨恨
hawk	n.鹰,隼
hay	n.干草
hazard	n.危险,冒险,危害 v.冒险,拼命
headmaster	n.校长
headquarters	n.司令部,指挥部;总部,总局
heal	v.治愈,愈合
heave	v.(用力)举，提，拉；扔；拖；呕吐n.举起
heaven	n.天,天空,天堂;(Heaven)上帝,神
hedge	n.篱笆,树篱,障碍物 v.用树篱围住
heel	n.脚后跟,踵,鞋跟
heir	n.继承人
helmet	n.头盔,钢盔
hemisphere	n.半球
hence	ad.从此,今后;因此
henceforth	ad.今后
herb	n.药草，(调味用的)香草，草本植物
herd	n.群,兽群,牛群 v.放牧,群集
heritage	n.遗产,继承物;传统
heroin	n.海洛因
heroine	n.女英雄;女主角
hesitate	v.犹豫,踌躇;含糊,支吾
hijack	v.劫持，劫机，拦路抢劫
hike	n.徒步旅行；增加vi.徒步旅行vt.提高
hinder	v.(from)阻止,妨碍 a.后面的
hinge	n.合页,铰链 vi.依…而定
hobby	n.业余爱好,嗜好,兴趣
hoist	v.举起,升起,吊起
hop	v.人单足跳;跳上(车等) n.蹦跳;短程飞行
horror	n.恐怖,战栗
hose	n.水龙带,软管 v.用软管(淋浇,冲洗)
hostage	n.人质
hostile	a.敌对的,敌方的,敌意的
hound	n.猎狗；卑鄙的人 vt.用猎狗追，追逐
housing	n.住房，住房供给；(外、阀)壳，防护罩
hover	vi.(鸟)盘旋，翱翔，(人)逗留在附近徘徊
howl	n.怒吼，嗥叫 vi.(风等)怒吼，咆哮
huddle	n./v.拥挤;聚集v.(因寒冷、害怕而)缩成一团
hug	v./n.热烈拥抱,紧抱
hum	v.哼曲子；发嗡嗡声；忙碌n.嗡嗡声，嘈杂声
humble	a.谦卑的,恭顺的;地位低下的 v.降低,贬低
humid	a.湿的,湿气重的
humidity	n.湿气,湿度
humiliate	v.使羞辱，使丢脸[同]disgrace
humorous	a.富于幽默感的，幽默的；滑稽的
hundred	num.百，一百；[pl.]许多 a.一百的；许多
hunt	v./n.打猎,猎取;(for)搜索;寻找
hurl	vt.猛投，力掷；大声叫骂
hut	n.小屋,棚屋
hypocrisy	n.伪善，虚伪
ignite	v.点火,引燃
illiterate	a.文盲的,未受教育的
illuminate	vt.照亮，照明；用灯光装饰；说明，阐释
immense	a.广大的,巨大的;[口]极好的
immerse	v.使沉浸在;使浸没
immigrant	a.(从国外)移来的,移民的 n.移民,侨民
immune	a.免疫的,有免疫力的;有受影响的;豁免的
impact	n.冲击,碰撞;影响 v.影响;挤入,压紧
impair	v.损害,损伤;削弱,减少
impart	vt.传授，给予；告知，通知
impetus	n.推动(力),促进
implication	n.含意，暗示，暗指；牵连
improve	v.改善,改进,增进;好转,进步
improvement	n.改进,进步,增进;改进措施
impulse	v.推动 n.推动;冲动,刺激
incentive	n.刺激;动力;鼓励;诱因;动机
incline	v.(使)倾斜;(使)倾向于 n.斜坡,斜面
incur	v.招致,惹起,遭受
indifferent	a.冷漠的,不关心的,不积极的
indignant	a.愤慨的,愤慨不平的
indignation	n.愤怒,愤慨
indispensable	a.(to,for)必不可少的,必需的
indoor	a.室内的,户内的
induce	v.引诱,劝使;引起,导致;感应
indulge	v.放任，纵容，沉溺；使(自己)纵情享受
inertia	n.不活动,惰性;惯性
inevitable	a.不可避免的,必然发生的
infant	n.婴儿,幼儿
infect	vt.传染，感染；影响(思想等)
infectious	a.传染的,传染性的,有感染力的
infer	v.推论,推断
inferior	a.下等的,下级的;劣等的,差的 n.下级,晚辈
ingenious	a.机敏的;有独创性的;精致的;精巧制成的
inhabit	vt.居住于,存在于;栖息于
inhabitant	n.居民,住户
inhale	v.吸入(气体等)，吸(烟)
inherent	a.固有的,内在的,天生的
inherit	vt.继承(金钱等)，经遗传而得(性格、特征)
inject	vt.注射(药液等)；注入
inlet	n.水湾,小湾;进口,入口
inn	n.小旅馆,客栈
innocent	a.(of)清白的,无罪的;无害的;单纯的,无知的
innovation	n.改革，革新；新观念，新方法，新发明
innumerable	a.无数的,数不清的
insect	n.昆虫
inspect	vt.检查,调查,视察
inspiration	n.灵感;鼓舞,激励
inspire	vt.鼓舞,激起;使产生灵感
instantaneous	a.瞬间的,即刻的
instinct	n.本能,直觉,天性
institute	n.学会,研究所;学院 v.设立,设置,制定
institution	n.公共机构;协会;学校;研究所;制度;惯例
insulate	vt.隔离,孤立;使绝缘,使绝热
insult	vt./n.侮辱,凌辱
intelligible	a.可理解的，明白易懂的，清楚的
intercourse	n.交流,交往,交际,性交
interfere	v.(in)干涉,干预;(with)妨碍,打扰
interference	n.(in)干涉,干预;(with)妨碍,打扰
interim	a.中间的,暂时的,临时的 n.过渡时期,暂定
interior	a.内部的,里面的 n.内部,内地
intermittent	a.间歇的,断断续续的
interrupt	v.中断,遮断,阻碍;打断(话),打扰
intersection	n.相交，交叉；道路交叉口，十字路口
intervene	v.(in)干涉,干预;插入,介入
intimidate	vt.胁迫，威胁(某人做某事)
intricate	a.复杂的,错综的,难以理解的
intrigue	n.阴谋v.密谋,私通;激起…的兴趣;诡计取得
intrinsic	a.(指价值、性质)固有的，本质的，内在的
intuition	n.直觉，直观；凭直觉而知的事物
invade	vt.入侵,侵略,侵袭,侵扰
invasion	n.入侵,侵略,侵犯
invent	v.发明,创造;捏造,虚构
invention	n.发明,创造,发明物
inventory	n.详细目录,存货,财产清册,总量
invitation	n.邀请,招待;请柬
inward	ad.向内,在内 a.向内的,在内的,里面的
irrigate	vt.灌溉，修水利 vi.进行灌溉
jam	n.阻塞,轧住;果酱 v.(使)阻塞,(使)轧住不动
jeans	n.牛仔裤（又称blue jeans, dungarees等）
jewel	n.宝石,宝石饰物
jug	n.(有柄，小口，可盛水等的)大壶，罐，盂
juice	n.(水果等)汁,液
junk	n.废物，旧货；舢板
kilo	n.(kilogram/kilogramme)千克
knock	v.敲,敲打,碰撞 n.敲,击
lace	n.花边;带子,鞋带 v.系带,扎带
lag	v./n.落后,滞后 vt.用隔热材料覆盖(锅炉等)
lash	v.鞭打,摆动,捆扎 n.鞭子,鞭打,睫毛,讽刺
latent	a.潜在的,潜伏的,不易察觉的
lateral	n.侧面的,旁边的
laughter	n.笑,笑声
laundry	n.洗衣房(店);待洗衣物,所洗衣物
lavatory	n.厕所,盥洗室
lawyer	n.律师
layman	n.外行
layoff	n.临时解雇,操作停止,活动停止期间,失业期
layout	n.安排，布局，设计；规划图，布局图
leaflet	n.小叶,嫩叶;传单,活页
lean	v.倾斜,屈身;倚,靠,依赖 a.瘦的,无脂肪的
leap	v.跳,跳跃 n.跳跃,飞跃
learned	a.博学的,有学问的
learning	n.知识,学问;学习
lease	vt.出租,租用 n.租借,租期,租赁物
leather	n.皮革,皮革制品
lecture	n./v.演讲,讲课
legacy	n.遗产，遗赠；先人(或过去)留下的东西
legislation	n.法律(规)；立法，法律的制定(或通过)
legitimate	a.合法的；合理的，合乎逻辑的 vt.使合法
lens	n.透镜,镜头
lest	conj.惟恐,免得
liberal	a.慷慨的,大方的;富足的;自由的,思想开放的
liberate	vt.解放,释放
liberty	n.自由，自由权；特权
librarian	n.图书管理员
lick	vt.舔；(火焰或浪)掠过；打败 n.舔；少量
lid	n.盖
limb	n.肢,翼,大树枝
limp	a.柔软的,易曲的 v./n.蹒跚,跛行
linen	n.亚麻布,亚麻布制品
liner	n.班机,定期轮船,邮船
lip	n.嘴唇
liquid	n.液体 a.液体的,液态的
liquor	n.酒；溶液，液剂
literacy	n.有文化,有教养,有读写能力
literature	n.文学,文学作品,文献,图书资料,印刷品
litre	n.(liter)升；公升(容量单位)
litter	n.垃圾,(杂乱的)废物 v.使杂乱,乱丢
liver	n.肝,肝脏
loaf	n.一个面包
locomotive	n.机车,火车头 a.运动的,移动的,运载的
lodge	v.临时住宿,寄宿,寄存,容纳n.传达室,小旅馆
lorry	n.卡车,运货汽车
lottery	n.抽彩；碰运气的事，难于算计的事
lounge	n.休息室,起居室,客厅
loyal	a.(to)忠诚的,忠贞的
loyalty	n.忠诚,忠心
lubricate	v.润滑,加润滑油,行贿,收买
luggage	n.行李,皮箱
lumber	n.木材,木料
lump	n.团,块 v.(使)成团,(使)成块
lunar	a.月亮的
lunch	n.午餐，(美)便餐
lung	n.肺
lure	n.吸引力,魅力,诱惑物 vt.引诱，吸引
machinery	n.(总称)机器,机械
mad	a.发疯的;狂热的,着迷的;恼火的,生气的
madame	n.(madam)夫人，太太，女士
magistrate	n.地方行政官，地方法官，治安官
magnificent	a.华丽的,高尚的,宏伟的
maid	n.少女,处女,女仆
maiden	n.少女,处女 a.未婚的,纯洁的,无经验的
majesty	n.雄伟,壮丽,庄严,威严;最高权威,王权
malignant	a.恶性的，致命的；恶意的，恶毒的
mammal	n.哺乳动物
maneuver	n.(manoeuvre)机动;运用,操作; v.机动
manifest	v.表明,证明,显示 a.明白的,明了的
mankind	n.人类
marble	n.大理石,云石
marine	a.海的,海生的;船舶的,航海的
marital	a.婚姻的,夫妻之间的
marriage	n.结婚,婚姻;结婚仪式
marvelous	a.(marvellous)惊人的,奇迹般的,妙极的
masculine	a.男性的，似男性的；［语法］阳性的
mass	n.大量,众多;团,块;(pl.)群众,民众;质量
massacre	vt.残杀,集体屠杀 n.残杀,大屠杀
massive	a.大而重的,厚实的,粗大的;大规模的,大量的
masterpiece	n.杰作,名著
mat	n.席子,垫子
match	n.火柴;比赛,竞赛;对手,配偶 v.匹配,相称
mate	n.伙伴,同事,同伴,配偶 v. 结伴,配对,交配
mature	a.成熟的,熟的;成年人的 v.(使)成熟
meadow	n.草地,牧场
meal	n.膳食,一餐
meantime	n.(meanwhile)其间,其时 ad.同时,当时
meanwhile	n.其时，其间 ad.当时，与此同时
mechanic	n.技工,机修工
mechanical	a.机械的,由机构制成的;机械似的,呆板的
mechanism	n.机械装置,机构;机制
medieval	a.中世纪的,中古(时代)的,老式的,原始的
meditate	v.想,考虑,(尤指宗教上的)沉思,冥想
meditation	n.熟虑;(尤指宗教的)默想,沉思;(pl.)冥想录
melody	n.旋律，曲调；悦耳的音乐
melon	n.甜瓜
memo	n.(memorandum)备忘录
memorial	a.记忆的,纪念的 n.纪念物,纪念碑,纪念馆
menace	vt./n.有危险性的人(或物)；威胁，威吓
mental	a.精神的,思想的,心理的,智力的,脑力的
mention	v./n.提及,说起
merchandise	n.商品,货物
mercury	n.水银,汞
mercy	n.仁慈,怜悯,宽恕
mere	a.纯粹的;仅仅,只不过
merit	n.优点,价值,功绩 v.值得,应得
mess	n.混乱,混杂,脏乱 v.弄脏,弄乱,搞糟
metal	n.金属,金属制品
metaphor	n.隐喻，暗喻
metre	n.(meter)米，公尺；仪表，计量器
metric	a.米制的,公制的
metropolitan	a.首都的,主要都市的,大城市
migrate	v.迁移,移居(国外)
militant	a.好战的，富于战斗性的 n.斗士
military	a.军事的,军用的,军队的
mill	n.磨粉机,磨坊;作坊,工厂
millimeter	n.(millimetre)毫米
millionaire	n.百万富翁
mineral	n.矿物,矿石 a.矿物的,矿质的
miniature	n.缩小的模型,缩图 a.微型的,缩小的
minister	n.部长,大臣
ministry	n.(政府的)部;牧师
minor	a.较小的,较小的 n.兼修学科 v.(in)兼修
minority	n.少数,少数派,少数民族
minute	n.分钟,片刻;(pl.)会议记录 a.微小的
mischief	n.损害,伤害,危害;恶作剧,胡闹;灾祸
miserable	a.痛苦的,悲惨的
misery	n.痛苦,悲惨,不幸
misfortune	n.不幸,灾祸,灾难
missile	n.导弹,发射物
mission	n.使命,任务;使团,代表团
mist	n.薄雾,霭
mistress	n.女主人;主妇;情妇,情人
moan	n.呻吟声,悲叹声 v.呻吟,抱怨,悲叹
mob	n.乌合之众(尤指暴力者) vi.围攻，聚众闹事
mobilize	v.(mobilise)动员,赋予可动性
mock	v.嘲笑 a.假的,模拟的 n.(常pl.)模拟考试
modest	a.谦虚的,有节制的
moisture	n.潮湿,湿气,湿度
molecule	n.分子
momentum	n.动力,要素
monarch	n.帝王，君主，最高统治者
monetary	a.金融的,货币的
monotonous	a.单调的,无变化的
monument	n.纪念碑,纪念馆,遗迹,不朽的业绩
mood	n.心情,情绪;语气
moral	a.道德(上)的,精神上的 n.寓意,教育意义
morality	n.道德,美德
moreover	conj./ad.再者,加之,而且
mortal	a.致命的;终有一死的;人世间的 n.凡人
mosaic	n.马赛克;镶嵌体
mosquito	n.蚊子
moss	n.苔,藓,地衣
most	a.最多的；大多数的 ad.最；极其 n.大多数
mostly	ad.几乎全部地;主要地,大部分,基本上
mould	n.(mold)模子，铸型 v.浇铸，造型，塑造
mount	v.登上;安装n.支架,底板;(用于山名前)山峰
mourn	v.哀悼,忧伤
mug	n.(有柄的)大茶杯
municipal	a.市(立,政)的;地方性的,地方自治的
murmur	v./n.小声说(话);小声抱怨,咕哝
muscular	a.肌肉的;肌肉发达的;强健的
mushroom	n.蘑菇 vt.迅速生长,迅速增加,采蘑菇
mute	a.哑的,缄默的n.哑巴;弱音器v.减弱…的声音
mutter	n.喃喃而语,小声低语;抱怨 v.低声说,抱怨
mutton	n.羊肉
mutual	a.相互的，彼此的；共同的，共有的
naked	a.裸体的,无遮敝的,无掩饰的
nap	n.小睡,打盹
napkin	n.餐巾,餐巾纸,<英>尿布
narrative	a.叙述性的 n.叙述
nasty	a.肮脏的,卑劣的,下流的;令人厌恶的
natural	a.正常的;自然界的,天然的,天赋的,固有的
naughty	a.顽皮的,淘气的
naval	n.海军的,军舰的
neat	a.整洁的,干净的,优美的,精致的
necessitate	v.使成为必要,需要
necessity	n.必要性,需要;必然性;(pl.)必需品
needle	n.针,指针,针状物
nephew	n.侄子,外甥
neutral	a.中立的;中性的,中和的
nickel	n.镍;镍币;五美分
niece	n.侄女,甥女
noble	a.高尚的;贵族的,高贵的 n.贵族
nonsense	n.胡说,废话
noon	n.中午，正午
nor	conj.／ad.也不，也没有
notorious	a.臭名昭著的,声名狼藉的
notwithstanding	prep./ad./conj.尽管
nurture	n./v.养育,教育,教养 n.营养品v.给与营养物
nut	n.坚果;螺母,螺帽
o'clock	ad.(…)点钟(与1至12数字连用)
odor	n.(odour)气味,香味,臭味,名声
opt	vi.抉择，选择
optimum	a.最适宜的 n.最适宜(条件)
orbit	n.轨道 v.(使)沿轨道行
orchard	n.果园,果园里的全部果树,<美俚>棒球场
orchestra	n.管弦乐队
orderly	a.整齐的,有秩序的,有条理的 n.勤务兵
ordinary	a.普通的,平凡的,平常的;平庸的
ore	n.矿石,矿砂
organ	n.器官;机构,机关;风琴
organic	a.器官的;有机的;有机体的
organism	n.生物，有机体
orient	n.东方,亚洲 v.使朝东,为…定位,使适应
oriental	a.东方的,东方诸国的 n.东方人
orientation	n.方向,方位,定位,倾向性,向东方
orphan	n.孤儿
outbreak	n.(战争,愤怒,火灾等的)爆发,(疾病的)发作
outfit	n.用具,机构,全套装配 v.配备,(得到)装备
outing	n.外出,旅行,散步
outrage	n.暴行,侮辱,愤怒 v.凌辱,引起…义愤,强奸
outset	n.开始,开端
outside	ad.向外面 n.外部 a.外部的 prep.在…外
outskirts	n.郊区
outstanding	a.突出的,显著的,杰出的
outward	a.外面的,公开的,向外的ad.向外,在外n.外表
oval	a.卵形的，椭圆形的 n.卵形，椭圆形
oven	n.炉,灶,灶箱
owe	v.欠(债等),应向…付出,归功于,得感谢
owing	a.欠的,未付的
owl	n.猫头鹰
ozone	n.臭氧；(海岸等的)新鲜空气
packet	n.小包裹,小捆;盒;一捆,一扎;邮船,班轮
pact	n.合同,条约,公约,协定
paddle	n.桨 v.用桨划
pail	n.桶, 提桶; 一桶的量
pain	n.痛,痛苦;(pl.)努力,劳苦 vt.使痛苦
paint	n.油漆,颜料 v.油漆;涂,涂漆;画;描绘,描述
painter	n.漆工,画家
pair	n.一对,一双;一副;夫妇 v.配对,成对
pale	a.苍白的,灰白的;浅的,暗淡的
pamphlet	n.小册子
panorama	n.全景,全景画,全景摄影,全景照片[装置]
pant	n.喘气 v.喘,气喘吁吁地说
pants	n.裤子, 短裤
parachute	n.降落伞 v.跳伞
parade	n./v.游行,夸耀n.检阅,阅兵式v.使列队行进
paradigm	n.典范; 范例; 示例
paradox	n.似非而是的话,自相矛盾的话,反论
paragraph	n.段,节;小新闻,短评
paralyze	v.(paralyse)使瘫痪(麻痹);使丧失作用
parasite	n.寄生虫,食客
parcel	n.包裹,邮包,部分 v.打包,捆扎,分配
pardon	n.原谅,宽恕;请再说一遍 v.原谅,饶恕,赦免
parent	n.父母,母亲;(pl.)双亲;父母
parliament	n.国会,议会
particle	n.粒子,微粒;极小量;小品词,虚词
partly	ad.部分地,不完全地,在一定程度上
partner	n.合作者,合伙人,合股人,伙伴,舞伴,配偶
passer-by	n.(pl.passers-by)过路人
pasture	n.牧草地,牧场
pat	v./n.轻拍,轻打,抚摸
pathetic	a.可怜的, 悲惨的
patience	n.耐心,忍耐
patient	a.有耐心的,能忍耐的 n.病人,患者
patriotic	a.爱国的
patrol	v.巡逻，巡查 n.巡逻，巡查；巡逻队
patron	n.赞助人；资助人；老顾客，老主顾
paw	n.爪
pea	n.豌豆
pearl	n.珍珠
peasant	n.(不用于英国或美国)小农;佃农;农民
pebble	n.卵石
peculiar	a.古怪的,异常的;特殊的,特有的
pedal	n.踏板 v.踩踏板,骑自行车
pedestrian	n.步行者 a.徒步的,呆板的,通俗的
peel	v.削皮,剥皮 n.果皮
peep	v.偷看,窥视
penalty	n.处罚,刑罚,惩罚,罚金
pendulum	n.摆,钟摆
pension	n.养老金,年金
pepper	n.胡椒粉,胡椒;辣椒
per	prep.每;经,由
perceive	v.察觉,感知;理解,领悟
perfume	n.香味,芳香;香料 v.使发香,洒香水于
perish	v.丧生;凋谢;毁灭,消亡
permanent	a.永久的,持久的
permeate	v.弥漫，遍布，散布；渗入，渗透
perpetual	a.永久的,永恒的,长期的
perplex	v.使困惑,使费解,使复杂化
persecute	v.迫害
persevere	v.坚持,坚忍,不屈不挠
persist	v.(in)坚持,持续
personnel	n.全体人员,全体职员;人事(部门)
persuade	v.说服,劝说;(of)使相信
persuasion	n.说服,说服力
pessimistic	a.悲观(主义)的
pest	n.害虫
petition	n.请愿书,申请书 v.(向…)请愿,正式请求
petty	a.小(器、规模)的,不重要的,细微的,卑鄙的
pharmacy	n.药房,药剂学,制药业,配药业,一批备用药品
picnic	n.野餐 v.(去)野餐
pigeon	n.鸽
pilgrim	n.(在国外)旅游者;朝圣者,最初的移民
pill	n.药丸
pillar	n.柱,台柱,栋梁
pilot	n.飞行员;领港员 v.驾驶(飞机等);领航,引水
pin	n.钉;大头针,别针,徽章 v.(up)钉住,别住
pinch	v.捏,掐,拧;收缩;紧急关头;匮乏;压力
pine	n.松树
pint	n.品脱
pioneer	n.先驱,倡导者,开拓者
pirate	n./v.海盗,盗版(者)
pistol	n.手枪
piston	n.活塞
pit	n.坑,陷阱;煤矿,矿井
pitch	n.沥青;掷 v.用沥青覆盖;投掷,扔
place	n.地方;名次;地位;寓所 v.安排;放置;投(资)
plague	n.瘟疫,灾害,麻烦,苦恼 vt.折磨,使苦恼
plain	a.明白的;朴素的;坦率;平凡 n.平原,旷野
planet	n.行星
plantation	n.种植园
plausible	a.似是而非的,似乎合理的,似乎可信的
plea	n.(法律)抗辩；请求，恳求，托词，口实
plead	v.恳求,请求;为…辩护;提出…为理由
pledge	n.誓约;保证 v.发誓;保证
plentiful	a.富裕的,丰富的
plot	n.秘密计划;情节 v.标绘,绘制;密谋,策划
plough	n.(plow)犁,耕地,犁过的地 v.犁,费力地前进
plug	n.塞子,插头 v.堵,塞,插上,插栓
plumber	n.(装修水管的)管子工
plunge	v.(into)(使)投入,(使)插进,陷入;猛冲
plural	a.复数的 n.复数
pneumonia	n.肺炎
poetry	n.诗歌,诗集
pole	n.柱,杆;地极,磁极,电极
pollute	v.弄脏,污染
pollution	n.污染
pond	n.池塘
ponder	v.沉思,考虑
pope	n.罗马教皇,主教,大腿上要害部位
porcelain	n.瓷器 a.精制的,瓷器的
porch	n.门廊,入口处
pork	n.猪肉
portable	a.轻便的,手提(式)的,可移动的
porter	n.守门人,门房,行李搬运工,服务员
portion	n.一部分,一份
portrait	n.肖像,画像
portray	v.描写，描述；画(人物、景象等)
possess	v.占有,拥有
possession	n.持有,拥有;所有权;所有物;(pl.)财产,财富
possibility	n.可能,可能性;可能的事,希望
postage	n.邮费,邮资
postcard	n.明信片
posture	n.姿势,姿态,心态,态度 v.作出某种姿势
poultry	n.家禽
pound	n.磅;英镑 v.(连续)猛击,(猛烈)敲打,捣碎
poverty	n.贫穷,贫困
powder	n.粉末,药粉;火药,炸药
preach	v.宣讲(教义),布道;竭力鼓吹,宣传;说教
precaution	n.预防,谨慎,警惕
preclude	v.排除,阻止,妨碍
preferable	a.(to)更可取的,更好的
preference	n.(for,to)偏爱,喜爱;优惠;优先选择
prejudice	n.偏见,成见;损害,侵害 v.使抱偏见,损害
preliminary	a.预备的,初步的
premier	n.首相,总理
premise	n.前提,房屋连地基v.提论,预述,假定
premium	n.额外费用,奖金,奖赏,保险费
preposition	n.介词
prescribe	v.指示,规定;处(方),开(药)
prescription	n.药方,处方
presence	n.出席,到场,存在,在
preserve	v.保护,维持;保存,保藏
preside	v.(at,over)主持
prestige	n.声望,威望,威信
presume	v.假定,假设,认为,揣测,滥用,擅自行动
prevalent	a.流行的,普遍的
prick	n./v.刺伤,刺痛,刺孔
priest	n.教士,神父
primitive	a.原始的,远古的,早期的;粗糙的,简单的
privilege	n.特权,优惠,特许 v.给予优惠,给予特权
probe	n.探针,探测器 v.(以探针等)探查,穿刺,查究
procedure	n.程序,手续,步骤
proficiency	n.(in)熟练,精通
programme	n.(program)节目,计划,规划,程序 v.编程序
prolong	v.拉长,延长,拖延
pronoun	n.代词
pronounce	v.发…的音;宣布,宣判
pronunciation	n.发音,发音方法
propaganda	n.宣传(机构)；[天主教]传道总会
propel	vt.推进，推动；激励，驱使
prophet	n.预言家；先知；提倡者
propose	v.提议,建议;提名,推荐;求婚
proposition	n.主张,建议;陈述,命题
prosecute	vt.实行，从事 v.起诉，告发 vi.作检察官
prosper	v.成功,兴隆,昌盛,使成功,使昌隆,繁荣
protein	n.蛋白质
proud	a.(of)自豪的;引以自豪的;妄自尊大的
prove	v.证明,证实;检验;考验;鉴定;结果是,表明是
provision	n.供应,(一批)供应品;预备;条款;(pl.)给养
puff	n.一阵,一股(气味等);喘息;吹嘘v.喘息,鼓吹
puppet	n.木偶,傀儡
purple	a.紫的 n.紫色
pursue	v.追赶,追踪;继续,从事
quarrel	v.争吵,争论 n.争吵,争吵的原因
queer	a.奇怪的,古怪的
quench	v.熄灭,扑灭,压制,抑制,止渴
questionnaire	n.调查表,问卷
quilt	n.被子
quiver	v./n.颤抖,抖动
quiz	n.小型考试,测验,问答比赛
quota	n.(生产、进出口等的)配额，(移民的)限额
rack	n.挂物架,搁物架 v.使痛苦,折磨
racket	n.球拍
radar	n.雷达
radiant	a.发光的,辐射的,容光焕发的
radiate	v.放射,辐射;散布,传播
radical	a.基本的,重要的;激进的,极端的;根本的
rag	n.抹布,破布,碎布
raid	n/v..袭击,搜查
rail	n.栏杆,围栏;(pl.)铁路;铁轨;横杆,栏杆
railroad	n.(railway)铁路 v.由铁道运输
rake	n.耙子,耙机 v.耙;搜索,探索
rap	n.叩击,轻拍,斥责 v.敲,拍,打,斥责,使着迷
rash	a.轻率的,鲁莽的 n.皮疹
rat	n.鼠
ray	n.光线,射线
razor	n.剃刀
react	v.反应,起作用;(against)反对,起反作用
reassure	v.使安心，使放心；使消除疑虑
rebel	v.反抗,反叛,起义 n.叛逆者,起义者
rebellion	n.叛乱,反抗,起义
recipe	n.烹饪法,食谱;诀窍,方法
recipient	a.接受的,感受性强的 n.接受者,感受者,容器
reciprocal	a.相互的,往复的,互利的
recite	v.背诵,朗诵
reckless	a.不注意的,大意的,卤莽的,不顾后果的
recollect	v.回忆,想起,记起,忆起,记得
reconcile	v.使和好,调解,使调和;(to,with)使一致
recreation	n.娱乐,消遣
recruit	v.征募(新兵)，吸收；补充 n.新成员，新兵
rectify	v.纠正,整顿, [化]精馏
recur	v.(尤指不好的事)一再发生；重现
reduce	v.减少,缩小;简化,还原
reduction	n.减小,减少,缩小
redundant	a.多余的,过剩的;(食物)丰富的;被解雇的
reed	n.芦苇,苇丛;芦笛,牧笛
reel	n.卷筒,线轴 v.卷,绕
refer	v.参考,查询;提到,引用,涉及;提交,上呈
refrain	v.节制,避免,制止 n.(诗的)叠句
refuge	n.避难处,藏身处
refund	n.归还,偿还额,退款 v.退还,偿还,偿付
refusal	n.拒绝,回绝
refute	v.反驳,驳斥
rehearsal	n.排练,排演,演习,预演,试演
rein	n.缰绳,统治,支配 v.驾驭,控制,统治
reinforce	v.增援,加强
rejoice	v.(使)欣喜,(使)高兴
religion	n.宗教,信仰
religious	a.宗教的,信教的,虔诚的
relish	n.美味,味道,调味品,食欲,乐趣 v.喜欢,品味
reluctant	a.不愿的,勉强的
remedy	n.药品;治疗措施 v.治疗,医治;纠正,补救
removal	n.移动,迁居;除去
renaissance	n.[the R-]文艺复兴(时期)；新生，复兴
renew	v.(使)更新,恢复,重新开始,继续
renovate	v.更新,修复
rent	v.租,租赁 n.租金
repay	v.偿还,报答
repel	v.击退,抵制,使厌恶,使不愉快
repertoire	n.节目,全部剧目,保留剧目,全部技能
repetition	n.重复,反复
reproach	v./n.责备,指责
resemblance	n.相似,相似性[点,物]
resemble	v.像,类似
resent	v.对…表示忿恨,怨恨
reservation	n.保留,保留意见;预定,预订
residence	n.住处,住宅
resign	v.辞去,辞职,使听从(于),使顺从
resist	v.抵抗,反抗;抗,忍得住,抵制
resistance	n.(to)抵抗,反抗;抵抗力,阻力;电阻
resistant	a.(to)抵抗的,有抵抗力的
restless	a.得不到休息的;不平静的;坐立不安的
restrict	v.限制,约束
retention	n.保留,保持,保持力,记忆力
retort	n./v.报复,反击,反驳
retrospect	v./n.回顾，回想，追溯[反]foresee
revenge	n.报复,复仇 v.替…报仇
revolt	v./n.反抗,起义
rib	n.肋骨,肋状物
ribbon	n.缎带,丝带,带,带状物
rid	v.(of)使摆脱,使去掉
riddle	n.谜,谜语
ridge	n.岭,山脉;屋脊;鼻梁
rifle	n.步枪
rigid	a.刚性的;刻板的;严厉的
rigorous	a.严格的,严厉的,严酷的,严密的,严谨的
riot	n.暴(骚)乱,蔓延,彩色缤纷 v.骚乱,暴动
ritual	a.宗教仪式的,典礼的 n.(宗教)仪式,典礼
rival	n.竞争者,对手 v.竞争,对抗 a.竞争的
roast	v.烤,炙,烘
rod	n.杆,棒
rope	n.绳,索
rotary	a.旋转的
rough	a.粗糙的;粗略的,大致的;粗野的,粗暴的
rub	v.擦,摩擦
rubber	n.橡皮,橡胶;橡胶制品,胶鞋
rubbish	n.垃圾,废物;废话
rude	a.粗鲁的;猛烈的,残暴的;粗糙的,粗陋的
ruin	v.毁灭;(使)破产 n.毁灭,崩溃;(pl.)废墟
rural	a.乡下的,田园的,乡村风味的
rust	n.铁锈 v.(使)生锈
ruthless	a.残酷的,无情的
sack	n.袋,包,麻袋 v.解雇
sacred	a.神圣的;宗教的;庄严的
saddle	n.鞍,马鞍,鞍状物
sail	n.帆,航行 v.航行
sake	n.缘故,理由
salad	n.色拉,凉拌菜
salute	v./n.敬礼,鸣礼炮;迎接,欢迎
salvation	n.拯救,救助;救济(者,品),救助工具;救世主
sanction	n./v.批准,同意,支持,认可 n.处罚,制裁
sane	a.心智健全的,神志清醒的,明智的,稳健的
sarcastic	a.讽刺的
satire	n.讽刺,讽刺文学,讽刺作品
sauce	n.酱汁,调味汁
saucer	n.茶托,碟子
sausage	n.香肠,腊肠
savage	a.野蛮的;凶恶的,残暴的 n.野人,未开化的人
scar	n.疤,疤痕;创伤 v.使留下伤痕,创伤
scarcely	ad.几乎不,简直没有,勉强
scarf	n.围巾,头巾,领巾,领带
scatter	v.散开,驱散;散布,散播
scent	n.气味,香味,香水,线索,嗅觉 v.嗅,发觉
scheme	n.计划,方案;阴谋;配置 v.计划,策划;阴谋
scissors	n.剪子
scold	v.责骂,训斥
scorn	v./n.轻蔑,藐视
scout	n.侦察员,侦察机(舰) v.搜索,侦察
scramble	vi.(快速地)爬，攀登；互相争夺，争先
scrap	n.碎片;废料 v.废弃,报废
scrape	v.刮(掉),擦过,勉强通过 n.刮,擦痕,刮擦声
scratch	v.抓,搔,扒 n.抓,搔,抓痕;起跑线
screw	n.螺旋,螺丝(钉) v.拧,拧紧
scrutiny	n.周密的调查；仔细看；监视；选票复查
sculpture	n.雕刻(术)，雕塑(术)；雕刻作品
segregate	vt.使···分开，隔离（病患等）
semester	n.学期
semiconductor	n.半导体
seminar	n.(大学的)研究班,研讨会
senator	n.参议员
sentiment	n.感情，柔情；看法；感觉
setback	n.挫折；失效；复发；倒退
severe	a.严厉的;剧烈的,严重的,严峻的,艰难的
sew	v.缝,缝纫
shady	a.成荫的,多荫的;可疑的,靠不住的
shaft	n.轴;杆状物
shall	aux.v.(我，我们)将要，会；必须，应该
sham	n./a.假冒(的)，虚伪(的)
shame	n.羞耻,耻辱;可耻的人(或事物) v.使羞愧
shampoo	n.洗发膏,香波;洗发,洗头 v.洗发,洗头
shark	n.鲨鱼
sharp	a.锋利的;轮廓分明的;急转的ad.(指时刻)正
shatter	n.碎片；粉碎　v.粉碎；使疲惫；使震骇
shed	v.流出;发散,散发,脱落,脱去 n.棚,小屋
sheer	a.纯粹的,十足的,全然的;陡峭的,险峻的
shepherd	n.牧民,牧羊人
shilling	n.先令
shine	v.照耀,发光;擦亮 n.光泽,光
shirt	n.衬衫
shore	n.海滨,湖滨
short	a.短的,矮的;(of)缺乏,不足 n.(pl.)短裤
shoulder	n.肩,肩部 v.肩负,承担
shout	v.大声叫，喊，呼出 n.呼喊，叫
shove	vt.乱推；乱塞vi.用力推，挤n.猛推
shower	n.阵雨;沐浴;(一)阵/大批v.下阵雨,倾注
shrewd	a.机灵的,敏锐的;精明的
shrug	vt./n.耸肩(表示冷淡、怀疑、无奈、不满等)
shy	a.怕羞的，腼腆的；胆怯的vi.惊退，畏缩
siege	n.包围，围攻，围困
sight	n.视力;望见,瞥见;视域;眼界;情景,奇观
signature	n.签名,署名,签字
silly	a.傻的,糊涂的,愚蠢的
sin	n.罪,罪恶 v.犯罪
sink	v.(使)下沉,下落 n.水槽,水池
siren	n.警报声,警报器
situated	a.坐落在…的
skate	v.溜冰,滑冰 n.冰鞋
skeptical	a.怀疑的 [英]sceptical
sketch	n.素描;略图,草图;梗概 v.绘略图,速写,写生
ski	n.雪橇 v.滑雪
skill	n.技能,技巧,手艺;熟练
skilled	a.(in)熟练的,有技能的;需要技能的
skillful	a.(skilful)(in,at)灵巧的,娴熟的
skim	vt.撇去(液体表面)之漂浮物 vi.轻轻掠过
skull	n.头盖骨，颅骨
slack	a.懈怠的,松驰的;萧条的 n.淡季;(pl.)便裤
slam	v.(门、窗等)砰地关上 n.猛然关闭的声音
slap	n./v.拍,掌击
sleeve	n.袖子
slide	v.(使)滑动 n.滑坡,滑道;滑,滑动;幻灯片
slight	a.轻微的,微小的;纤细的,瘦弱的
slim	a.苗条的;(机会)少的 v.减轻体重,变苗条
slip	v.滑,滑倒;滑掉;溜走n.疏忽,小错,口误,笔误
slipper	n.便鞋,拖鞋
slippery	a.滑的,滑溜的
slit	v.切开,截开,纵割 n.细长裂缝,狭长切口
slogan	n.标语,口号
slope	n.斜坡,斜面;倾斜,斜度 v.(使)倾斜
slum	n.贫民窟,贫民区,陋巷
sly	a.狡猾的,偷偷摸摸的
smash	v./n.打碎,粉碎
smell	n.气味;嗅觉 v.嗅,闻到;散发(…的)气味
smuggle	v.走私;偷运
snap	v.啪地移动；(使）突然断开，断开（成两截)
snatch	n./v.攫取,抢夺
sneak	vi.偷偷地走，溜vt.偷偷地做(或拿、吃)
sneeze	vi.打喷嚏，发喷嚏声n.喷嚏
sniff	vi.嗅…味道；抽鼻涕；对嗤之以鼻，蔑视
soak	v.浸泡,浸湿,浸透
soil	n.泥土,土地,土壤 v.弄脏,(使)变脏
solar	a.太阳的,日光的
solemn	a.庄严的,隆重的;严肃的
solve	v.解决,解答
sorrow	n.悲衰,悲痛
sow	v.播种
spade	n.铁锹,铲子
speak	v.说话，讲话；演说，发言；(in)说某种语言
specimen	n.标本,样本
spectacle	n.(pl.)眼镜;场面,景象;奇观,壮观
spectacular	a.壮观的,引人注目的 n.壮观的演出
spectator	n.观众,旁观者
spectrum	n.谱，光谱，频谱；范围，幅度，系列
spicy	a.加很多香料的；(口味)浓郁的
spill	v.溢出,溅出 n.摔下,跌下
spine	n.脊柱，脊椎；(动植物的)刺；书脊
spiral	a.螺旋形的 n.螺旋，螺线 v.螺旋上升；盘旋
spiritual	a.精神(上)的,心灵的
spit	v.吐(唾沫),吐痰 n.唾液
spite	n.恶意;怨恨
splash	v.溅,泼 n.溅,飞溅声
splendid	a.壮丽的,辉煌的;极好的
spoil	v.损坏,搞错;宠坏,溺爱
sponge	n.海绵
spontaneous	a.自发的,自然产生的
spoon	n.匙,调羹
spouse	n.配偶(指夫或妻)
spray	n.喷雾,飞沫,浪花,水花 v.喷,喷射
sprinkle	n.洒,喷,淋
sprout	vi.发芽，抽条 vt.使发芽 n.新芽，嫩苗
spur	n.靴刺,马刺;刺激,刺激物 v.刺激,激励
squirrel	n.松鼠
stab	v./n.刺,戳
stability	n.稳定,安定
stadium	n.体育场
stage	n.舞台,戏剧;阶段,时期
stagger	vi.摇晃着移动;蹒跚 n.摇晃不稳的动作;蹒跚
stain	n.污点,瑕疵 v.沾污;染色
staircase	n.(stairway)楼梯
stake	n.桩,标桩;赌注,利害关系
stale	n.变质的,不新鲜的;陈旧的,陈腐的
stall	n.货摊;畜栏,厩 v.(使)停转,(使)停止
stamp	n.邮票;印;跺脚;标志v.跺脚,顿足;盖章
staple	n.主要产品；名产；纤维；主要成分，主食
stare	v.(at)盯,凝视
startle	v.惊吓,使吃惊
statesman	n.政治家,国务活动家
stationary	a.静止的,固定的
stationery	n.文具
statistical	a.统计的,统计学的
statute	n.成文法，法令，法规；章程，规则，条例
steady	a.稳定的,不变的;坚定的v.(使)稳固/稳定
steak	n.牛排；大块肉(或鱼)片
steam	n.水汽,蒸汽,水蒸气 v.蒸发;蒸;用蒸汽开动
steamer	n.汽船,轮船
steep	a.陡峭的；险峻的；急剧升降的vt.浸泡,沉浸
steer	vt.驾驶，为…操舵；引导vi.驾驶
stem	n.茎，干 vt.堵(挡)住 vi.起源于，由…造成
stern	a.严厉的;坚决的,坚定的 n.船尾,舟尾
steward	n.乘务员，服务员；看管人；膳食管理员
stiff	a.硬的,僵直的;拘谨的;呆板的;艰难的
sting	v./n.刺,刺痛,剧痛;刺,叮
stir	v.搅拌,搅动;动,摇动;激动;轰动;煽动,鼓动
stitch	n.一针；(因跑步引起的)肋部剧痛 v.缝(合)
stomach	n.胃，胃口；肚子，腹部vt.承受，忍受
stool	n.凳子；(pl.)大便
stoop	v.弯腰,俯身 n.弯腰,曲背
stove	n.炉子,火炉
strain	v.拉紧;紧张;扭伤;竭尽全力 n.拉紧;负担
strap	n.皮带，带子v.用带扣住，束牢；用绷带包扎
straw	n.稻草,麦杆;吸管
strawberry	n.草莓
strenuous	a.费力的，艰辛的；奋发的，努力的
stress	n.压力；重要性；应力；重音vt.强调，重读
stretch	v.伸展，延伸 n.拉长；伸展；一段时间/路程
strict	a.(with)严格的,严厉的;严谨的,精确的
stride	vi.大踏步走；跨越 n.一大步(pl.)长足进步
strife	n.争吵；冲突，斗争；竞争
striking	a.显著的；惹人注目的，容貌出众的
string	n.弦,线,细绳;(一串),(一行) v.缚,捆
strive	v.奋斗,努力
stroke	n.击;报时的钟声;一击/划/笔;中风 v.抚摸
stroll	n.&v.漫步；散步；游荡
struggle	n./v.斗争,奋斗,努力
stubborn	a.顽固的,倔强的;难对付的,难以克服的
stun	vt.使…失去知觉；使目瞪口呆，使吃惊
sturdy	a.坚定的，不屈不挠的；强健的，结实的
subjective	a.主观(上)的，个人的
submarine	n.潜水艇 a.水底的,海底的
submerge	v.沉没,淹没;潜入
subordinate	a.(to)次要的,从属的;下级的
subsequent	a.随后的,后来的
subsidy	n.补助金；津贴费
substance	n.物质；实质，本质；主旨；财产，资产
substantial	a.实质的;相当的;显著的;坚固的;富裕的
substitute	n.代替者；替身；代用品 v.(for)代替,替换
subtle	a.精巧的,巧妙的;细微的,微妙的
subtract	v. (from)减(去)
suburb	n.市郊,郊区
succession	n.连续,系列;继任,继承
successive	a.接连的,连续的
sudden	a.出乎意料的，突然的
sue	v.控告,对…提出诉讼,起诉
suffice	v.充足，足够；vt.(食物等)使(某人)满足
suite	n.套间；一套家具；套，组，系列
sulfur	n.(sulphur)硫
summon	v.召唤;传讯,传唤;鼓起(勇气),振作(精神)
superb	a.极好的,杰出的；华丽的；
superficial	a.表面的;肤浅的,浅薄的
superfluous	a.多余的，过剩的，
superior	a.优良的,卓越的;上级的 n.上级;长者;高手
superiority	n.优越(性)，优势，优等；高傲，傲慢
supermarket	n.超级市场
supersonic	a.超音速的,超声波的 n.超声波，超声频
superstition	n.迷信，迷信的观念习俗
supplement	n.补遗;增刊;附录 v.增刊,补充
suppress	v.镇压,压制;抑制,忍住;查禁
supreme	a.极度的,最重要的;至高的,最高的
surge	vi.汹涌；彭湃；蜂拥而至 n.巨浪;汹涌;彭湃
surgeon	n.外科医生
surgery	n.外科,外科学;手术室,诊疗室
surpass	vt.超过,胜过
surrender	vi.投降，屈服 vt.放弃，交出 n.投降，认输
survey	v./n.俯瞰,眺望;全面审视,调查;测量图,勘定
susceptible	a.易受影响的;易受感动的;易受感染的
suspicion	n.怀疑，猜疑；一点儿，少量
suspicious	a.(of)可疑的,多疑的,疑心的
swallow	n.燕子;吞咽vt.吞,咽;轻信;忍受;vi.咽口水
swamp	n.沼泽；湿地 vt.浸没；使…应接不暇
swarm	n.蜂群;一大群 vi.涌往;挤满;云集;成群移动
sway	vi.摇动；倾斜 vt.使摇动 n.摇动；影响力
sweat	n.汗 v.(使)出汗
sweater	n.毛衣,绒衣,厚运动衫
swell	n./v.肿胀;膨胀;增大;增加;
swim	vi.游泳;游;漂浮;眩晕;充溢 vt.游过 n.游泳
swing	v.摇摆,摇荡,回转,旋转 n.秋千;摇摆,摆动
switch	n.开关；转换；鞭子 v.转变,转换；抽打
symphony	n.交响乐,交响曲
symposium	n.讨论会,专题报告会;专题论文集
symptom	n.(疾病的)症状；(不好事情的)征兆,表征
syndrome	n.综合病征；并存特性
tablet	n.药片;碑,匾
tackle	n.滑车;用具,器械 v.处理,解决;抱住,抓住
tame	a.驯服的,温顺的;沉闷的,乏味的 vt.驯服
tan	n./a.(皮肤因日晒而成)棕褐色(的) vt.晒黑
tar	n.柏油，焦油 vt.涂或浇柏油/焦油于
tariff	n.关税,税率;(旅馆,饭店等)价目表,收费表
tear	n.(pl.)眼泪 vt.撕裂；使…分裂 vi.破裂
tedious	a.乏味的,单调的,冗长的
temperament	n.气质，性格，性情；资质
temperature	n.温度，体温；热度，发烧
tendency	n.趋势，趋向；倾向
tennis	n.网球
tense	n.时态 v.拉紧，(使)紧张 a.绷紧的，紧张的
tentative	a.试探性的，暂时的；犹豫不决的
theoretical	a.理论(上)的
therapy	n.治疗，(不需要药物或手术的)物理疗法
thermal	a.热的,热力的；(小规模的)上升气流
thermometer	n.温度计
thesis	n.(pl.theses) 论文;论题;论点
thigh	n.大腿；股骨
thirteen	num./a.十三 pron.十三(个，只...)
thrift	a.节约，节俭
thrill	n.一阵激动(恐惧) v.激动；(使)毛骨悚然
thrust	vt.插入；猛推 n.插，推力 vi.刺，戳，冲
tight	a.紧的;紧身的,装紧的;密封的 ad.紧紧地
tile	n.瓦片,瓷砖 vt.铺瓦于，贴砖于
tilt	v.(使)倾侧；(使)倾斜 n.倾侧；倾斜
timid	a.胆怯的,怯懦的
tire	v.(使)疲倦,(使)厌倦 n.(=tyre)轮胎,车胎
tired	a.疲劳的;厌倦的
tiresome	a.使人厌倦的,讨厌的
toast	n.烤面包,吐司;祝酒(词)v.烘,烤;(向…)祝酒
tomb	n.坟,冢
tongue	n.舌;语言
torch	n.手电筒;火炬,火把
toss	vt.向上掷/扔；摇摆，颠簸 n.投，扔；摇动
tough	a.坚韧的,棘手的;强健的,吃苦耐劳的;粗暴的
toward	prep.(towards)朝，向；将近；对于；为了
towel	n.毛巾 vt.用毛巾擦或擦干
tragic	a.悲剧的,悲惨的
traitor	n.叛徒,卖国贼
tram	n.有轨电车
tramp	n./v步行;沉重的脚步声(走)v.践踏n.流浪者
transcend	vt.超出,超越(经验、知识、能力的范围等)
transistor	n.晶体管；晶体管收音机
transition	n.转变，变迁，过渡(时期)
transmission	n.播送,发射;传动,传送
transmit	vt.传输/导；转送；发射 vi.发射信号；发报
tray	n.盘,碟,托盘
treason	n.谋反,通敌,叛国
treasure	n.财宝,财富;珍品 v.珍爱,珍惜
treat	v.对待;治疗;论述;款待,请客 n.款待,请客
treaty	n.条约，协议，协商
trench	n.&v.(挖)沟，(挖)战壕
trial	n.讯问，审讯；试验；试用；尝试
tribe	n.种族，部落；(植物，动物)族，类
trick	n.诡计,骗局;恶作剧;窍门 vt.欺骗,哄骗
trifle	n.少量；小事,琐事 v.玩弄；嬉耍；忽视
trim	a.整齐的,整洁的 v./n.整理,修整,装饰
trivial	a.琐碎的;无足轻重的
trolley	n.手推车;(英)无轨电车,(美)有轨电车
tropic	n.回归线；[the T-s]热带地区
tropical	a.热带的
truck	n.卡车,载重汽车
trunk	n.大衣箱,皮箱;(汽车后部)行李箱;树干,躯干
tub	n.木盆,澡盆
tube	n.管,软管;电子管,显像管;地铁
tuck	v.卷起;塞进
tumble	v.(使)摔倒;打滚,翻腾 n.摔跤,跌倒
tumour	n.(tumor)(肿)瘤，肿块
tutor	n.导师;家庭教师 v.辅导;当导师;当家庭教师
twin	a.双的,成对的,孪生的 n.孪生子,双生子
twinkle	vi.(星等)闪烁，(眼情)发亮 n.闪烁，闪光
twist	v.捻;拧;扭曲;蜿蜒曲折而行 n.拧;歪曲;曲折
typewriter	n.打字机
typhoon	n.台风
typist	n.打字员
ultraviolet	a./n.紫外线(的)
unanimous	a.全体一致的,一致同意的
underlie	vt.位于...之下, 成为...的基础
undermine	v.暗中破坏,逐渐削弱;侵蚀…的基础
underneath	prep.在…下面 ad.在下面,在底下
undertake	v.承担,担任;许诺,保证;着手,从事
uneasy	a.不安的,焦虑的
unify	v.使联合,统一;使相同,使一致
unity	n.团结;统一,一致,整体
university	n.(综合)大学
upgrade	v.提升,使升级
uphold	vt.支持,赞成;举起;坚持
upon	prep.在…上；在…旁 [=on]
upright	a.垂直的,直立的;正直的,诚实的 ad.竖立着
uproar	n.骚动,喧嚣,鼎沸
urgent	a.急迫的，紧要的，紧急的
utilize	vt.利用
utmost	a.最远的;极度的 n.极限,极度,最大可能
utter	v.说,发出(声音) a.彻底的,完全的
vacant	a.空的,未占用的;空缺的;神情茫然的
vacation	n.休假,假期
van	n.有篷汽车;有篷货运车厢
vanish	vi.突然不见;消失
vanity	n.虚荣心,浮华
vapour	n.(vapor)汽，(水)蒸气
vase	n.花瓶,瓶
vegetable	n.蔬菜,植物 a.植物的,蔬菜的
vegetarian	n.素食主义者
vegetation	n.植物,草木
veil	n.面纱,遮蔽物 v.用面纱掩盖,掩饰
vein	n.血管;静脉;叶脉;纹理;情绪 vt.使成脉络
velocity	n.速度,速率
velvet	n.丝绒,天鹅绒 a.丝绒制的,柔软的
ventilate	vt.使通风;给…装通风设备
venture	v.冒险,拼;大胆表示 n.冒险事业,拼,闯
verb	n.动词
verbal	a.用言辞的,用文字的;口头的;动词的
verdict	n.(陪审团的)裁决,判决；判断；定论
verge	n.边,边缘 v.濒临
versatile	a.通用的;多才多艺的,多方面的
verse	n.韵文,诗;诗节,诗句
version	n.版本;译本,译文;说法
vessel	n.容器,器皿;船,舰;管,血管
vest	n.背心,马甲;汗衫,内衣
veteran	n.老手,老兵
veto	n./v.否决
vice	n.邪恶;恶习;(pl.)台钳,老虎钳
vicinity	n.邻近,附近
vicious	a.恶毒的,凶残的,邪恶的
vigorous	a.朝气蓬勃的,精力旺盛的
vinegar	n.醋
virgin	n.处女 a.处女的;纯洁的;原始的;未使用的
virtue	n.德行,美德;贞操;优点;功效,效力
virus	n.病毒;(精神,道德方面的)有害影响
vital	a.生死攸关的,重大的;生命的,生机的
vocal	a.声音的;有声的;歌唱的 n.元音;声乐作品
vocation	n.职业;召唤;天命;天职;才能
volcano	n.火山
volt	n.伏特
voltage	n.电压
vowel	n.元音,元音字母
vulgar	a.粗俗的，庸俗的，本土的，通俗的，普通的
vulnerable	a.易受攻击的
waist	n.腰,腰部
wander	v.漫步,徘徊;迷路,迷失方向;离题
ward	n.病房;行政区;监护;被监护人 vt.挡住
wardrobe	n.衣柜,衣厨;衣服;行头;剧装
warehouse	n.仓库,货栈
warfare	n.战争(状态);斗争;冲突
warmth	n.暖和,温暖;热心,热情
waterproof	a.防水的,耐水的
watt	n.瓦,瓦特
wax	n.蜡,蜂蜡 v.打蜡
weak	a.虚弱的,软弱的;不够标准的;淡薄的,稀的
weary	a.疲倦的;令人厌烦的 v.使疲倦,使厌倦
wedge	n.楔,楔形 vt.楔牢,楔入,挤进
weed	n.杂草,野草 v.除草,锄草
weep	v.哭泣,流泪;滴下 n.哭泣
weigh	v.称…重量,称;重达;考虑,权衡
weird	a.古怪的，离奇的；怪诞的，神秘而可怕的
weld	v.焊接 n.焊接,焊缝
well	ad.好，令人满意地；很 int.哎呀，好啦，嗯
whale	n.鲸；庞然大物
wheat	n.小麦
whereas	conj.而,却,反之
whip	n.鞭子;车夫 v.鞭打,抽打;突然移动
whirl	v.(使)旋转,打转 n.旋转;-连串快速的活动
whisky	n.威士忌酒
whisper	v.耳语;私下说,偷偷告诉 n.耳语;传闻
whistle	n.口哨,汽笛;口哨声,汽笛声 v.吹口哨;鸣笛
wholesome	a.卫生的;有益的;健康的,有益健康的
wholly	ad.完全地,全部,一概
wink	v.(使)眨眼；眨眼示意 n.眨眼；小睡，打盹
wipe	v./n.擦,揩,抹
wire	n.金属线,电线;电报,电信 v.发电报(给)
without	prep.无，没有 n.外面，外部
withstand	vt.抵抗,经受住
wonder	n.惊奇,惊异;奇迹,奇事 v.(at)诧异;想知道
wool	n.羊毛,毛线,毛织品
word	n.词，词语；言语，话；谈话；消息，信息
wreath	n.花环,花圈
wretched	a.可怜的;悲惨的;肮脏的;恶劣的
yawn	v.打呵欠 n.呵欠
zeal	n.热心，热忱，热情
zebra	n.斑马
zigzag	n./a.之字形(的) v.使曲折,曲折盘旋
zinc	n.锌
zoom	vi.(飞机)陡升 n.陡升；嗡嗡声
