有效的	effective	valid	active
手的	manual
[生物学]亲和的	compatible
半个的	half
理解力强的	intelligent
完好无损	intact
（时间上）紧接着的	adjacent
红宝石的	ruby
仔细的	careful	minute	narrow
应急的	emergency	jury
真空的	vacuum
西方的	western
有节制的	moderate	sober
[地质学]原生的	primary
占优势的	dominant	predominant
顽固的	contrary	resistant	rigid	set	stiff	stubborn
（风、光线）来自东北方向的	northeast
当今的	now
无论哪些	whichever
朝气蓬勃的	vigorous
筋疲力尽的	shot
荒唐的	absurd	ridiculous
用图表示的	graphic
有同情心的	feeling	sympathetic
国家的	national	state
四散的	diffuse
多心	suspicious
牢固的	secure	tight	tough
实体的	objective
严寒的	bitter
骇人的	scare
奸诈的	cunning	shrewd
财政的	financial	monetary
下贱的	low	mean
产生紫外线的	ultraviolet
阴历的	lunar
礼仪上的	formal
古代的	ancient	antique
紫罗兰色的	violet
额外的	more	additional	excess	extra
badly的比较级)	worse
不屈不挠的	tough
有系统的	scientific	systematic
户内的	indoor
粗野的	bush	coarse	robust	vulgar
可会见的	available
成问题的	problem
末了的	latter
闪耀的	brilliant	flash
可能的	feasible	likely	possible	probable	prospective
首次的	maiden	opening
古命运的	weird
全部的	entire	overall	total	whole	all
需付费的	pay
第一位的	banner
被免除的	exempt
混乱的	complicated	turbulent	upset	disrupt
〈口〉抱好感的	sympathetic
经过特殊加工（或处理）的	process
慢的	slow
精通学理的	scientific
圣洁的	holy
超等的	super
（计算机）虚拟的	virtual
票面上的	nominal
雄辩的	eloquent
简约	concise
选出而尚未上任的	designate
能够的	able
热门的	hot
有弹性的	spring
小山羊皮制的	kid
维持生命所必需的	vital
不可靠的	dubious	slippery
原来的	late
外表庄严和庄重的	noble
经验主义的	empirical
倒数的	reciprocal
不景气的	flat
忽然的	unexpected
塑料[塑胶]制的	plastic
桌子的	table
理智的	rational
崭新的	new
深思熟虑的	deliberate	thoughtful
丰足	abundant
较粗硬的	horse
朝西的	west
股票行情下跌的	bear
背面的	wrong
有咸味的	salt
羞怯的	modest	timid
激进的	militant	radical
弹性的	stretch
被传授初步知识的	initiate
过度的	extravagant	excessive
极坏的	disastrous	rotten
（光、颜色等）鲜艳的	vivid
元音的	vowel
共和政体的	republican
戒备的	jealous
奇怪的	peculiar	strange	weird	bizarre
（石料	dimension
中意的	favorite
逻辑的	logic
最早的	first	premier	primary
预备的	preliminary	reserve	spare
金刚石的	diamond
阴柔的	feminine
蠢的	silly
（语言使用上）不分男女的	inclusive
积极的	positive	active
领头的	lead
幼小的	chicken	little	infant
深红棕色的	bronze
流行性的	epidemic
初步的	preliminary	initiative
经久的	permanent
高声的	loud	loud
凭经验的	empirical
（脉搏等）急促的	frequent
低级的	base	small
大城市的	metropolitan
枯燥的	bald	dry	rigorous
乳白色的	ice-cream
不吉的	evil
错误的	erroneous	faulty	wrong
骚乱的	turbulent
[医]勃起的	erect
有两种或多种意思的	ambiguous
表面的	apparent	shallow	surface	exterior
含泪的	moist
性质等）一样的	uniform
有酸味的	sour
南方吹来的	south
难解的	difficult	abstract
受范的	plastic
新式的	modern	up-to-date
劣质的	cheap	terrible
黑种人的	black
正在考虑的	instant
动词的	verbal
某个	some
拘谨的	stiff
很好的	class
令人瞩目的	noticeable
不受任何限制[约束]的	absolute
盲目轻信的	fond
井的	well
蘑菇形的	mushroom
[生]倒卷的	reverse
数一次的	linear
相似物的	analogue
妒忌的	jealous
奇数的	odd
貌似有理的	plausible
能结果实的	female
待在家里的	indoor
真的	real	so	authentic
合伙的	associate
有敌意的	ugly
使人兴奋的	exciting
（价格等）高价的	fancy
长期的	chronic	durable
一家的	household
发动的	motive
（物质）致密的	compact
数量（上）的	quantitative
整体的	global	integrate
晴朗的	fair	fine	pleasant
一方的	one
可信的	authentic
难以忍受的	impossible
富有感情的	feeling
无上的	supreme
首都的	capital
有教养的	polite
圆熟	skillful
神经紧张的	tense
备用的	auxiliary	spare
骑在马背上的	horse
快的	brisk	fast	frequent	quick	sudden
需要勇气的	brave
本土的	mainland
用于跳舞的	dance
构成或使用言语的	oral
东南部的	southeast
适于一人的	single
老是那一套的	usual
雄的	bull
令人失望的	chill
（文体等）臃肿的	clumsy
引人注意的	spectacular
快活的	jolly	merry	pat
出于礼节的	courtesy
（级别或地位）低下的	humble
所有的	whole
清静的	quiet
有恶臭的	foul
力大如牛的	bull
南方的	southern
星形的	star
有声音的	vocal
[数学]正交的	normal
吵吵闹闹的	noisy
咨询的	directory
高等的	high	advanced
惟一的	single	sole
有雄心的	ambitious
“late”的比较级	latter
服现役的	service
堂堂的	August
法律上的	technical
黄种人的	yellow
极讨厌的	horrible
干脆的	flat
迟钝的	blunt	opaque	stupid	dull	slow
赛狗）起点标志的	post
闹市区的	downtown
经验丰富的	veteran
拖欠的	back
自大的	arrogant
口极端的	fearful
果断的	decisive
有奇异魔力的	magic
被豁免的	exempt
闻	well-known
缺乏决心的	feeble
易受骗的	simple
称赞的	favorable
易看见的	apparent
乡下的	rural
过早的	previous
士兵的	private
最大的	most	top	ultimate	utmost
在实地工作的	field
卧式的	horizontal
推论的	material
骨骼的	skeleton
有强烈感情（或意见、想法）的	intense
意外的	chance	extraordinary	unexpected	abrupt	accidental
残留的	remnant
极度的	mortal	super	utmost	all	excessive
学理上的	academic
众所周知的	well-known
法律的	legal
优秀的	class	crack	good	master	rare	excellent
指定而尚未上任的	designate
都市的	municipal	urban
警察的	police
[化学]碱性的	basic
诚挚的	earnest	sincere
得体的	decent	graceful
尽量的	all
导向的	pilot
蓝色的	blue
随便写用的	scratch
[建]综合式的	composite
可怕的	awful	dread	fearful	formidable	grim	horrible	nightmare	terrible	terrific	tremendous
响亮的	loud	loud
令人生厌的	tedious	tiresome
达到结尾的	complete
名义上的	nominal
灰色的	grey
联立的	simultaneous
可评估的	valuable
精干的	lean
乳品业的	dairy
细长的	slim
不完美的	faulty
首字母的	initial
似纸的	paper
未完成的	outstanding
同一的	same	self
用以产生真空的	vacuum
定质的	qualitative
球体的	global
潮湿的	damp	humid	moist
荒凉的	bleak	desolate	lonely	wild
根据民法的	civil
刑事的	criminal
狭隘的	narrow
价格低廉的	budget
有斑纹的	zebra
贞洁的	continent
从商店里买来的	store
腻烦的	sick
年幼的	young
直率的	blunt	frank	straight
一千个的	thousand
无穷的	infinite
作信号用的	signal
有弹力的	elastic
不利的	hostile	minus	adverse
中立的	neutral	indifferent
多雨的	moist
有封面的	bound
[植]辐状的	rotate
发腻]的	weary
冷酷的	grim	ruthless
暴怒的	furious
中部的	middle
整个的	entire	mass
今…	this
即时的	ready
唇音的	lip
渴望的	anxious	eager	greedy	hungry
多云的	cloudy
无关紧要的	futile	indifferent
民主政体的	democratic
第一的	premier
十足的	thorough	very
书的	book
使完美	polish
深思熟虑	considerate
不坏的	possible
精美的	porcelain
〈美〉乘客名额有限制的	limited
提供金钱	situated
（在政府中）无代言人的	dumb
次于的	next
长音的	long
孤注一掷的	desperate
一年间的	yearly
犹豫的	solemn
花钱少的	budget
不起眼的	quiet
对不起的	sorry
适应的	accustomed
难以对付的	formidable
不锋利的	blunt
准时的	punctual
护送	conduct
老式的	ancient	obsolete
须穿礼服的	dress
使人厌烦的	painful
公的	bull
符合时尚的	fashionable
（伤口等）发炎的	angry
列名的	nominal
激流的	turbulent
户外的	outdoor
急速的	quick
冗长的	diffuse	long
（人）从容不迫的	calm
一点	any
庸俗的	vulgar
用文字表示的	graphic
碰巧的	chance	scratch
[口语]近便的	convenient
来自北方的	northern
内疚的	guilty
宽宏大量的	kind
不祥的	ugly
（颜色等）朴素的	grave
忠诚的	faithful	loyal
物有效的	virtual
无论哪一个	whichever
双联的	twin
相似的	like	similar	alike
光滑的	smooth
精炼	concise
（风）来自南方的	south
开明的	liberal
热烈兴奋的	furious
偶然的	casual	chance
宏伟的	grand
（化学中）中性的	neutral
无法逃离的	captive
延伸的	continuous
&pron.that的复数	those
（用以强调）完全的	complete
饱和的	saturate
有害的	bad	destructive	evil	poisonous	adverse
母音的	vowel
很快的	overnight
浓密的	heavy	shock	dense
本部的	home
贴近的	next
遗传的	genetic
级别最高的	chief
亲密的	bosom	close	confidential	friendly	near	intimate	inward
十进制的	metric
边缘的	fringe	marginal
银制的	silver
政府的	public
个头很小的	toy
压缩的	capsule
健康的	better	fine	tidy	well	healthy
提前的	beforehand
位于东南的	southeast
（口）稀奇的	funny
广泛的	comprehensive	broad
自私的	mean	selfish
代价高的	costly
领地的	feudal
互助的	friendly
爱挑剔的	critical
数不清的	numerous	innumerable
无说服力的	lame
神妙	wonderful
选中的	elect
记叙英雄及其事迹的	heroic
明星的	star
可能性极小的	mathematical
（人的想像）丰富的	vivid
发怒的	angry	sore
栎树的	oak
湿的	wet
未使用的	virgin
理论上的	abstract
（以…）落后于对手的	down
需要专门知识（或技术）的	expert
政党的	party	political
宗主国的	metropolitan
惹人注意的	conspicuous
小数的	decimal
有决定权的	competent
大概的	approximate	most	probable
成块的	lump
越冬的	winter
冰的	ice
创始的	initiative
口齿不清的	dumb
（电话）接通	through
无意的	feeble
恶臭的	rank	rotten
绕圈子的	roundabout
历史上的	historic	historical
素净的	sober
陈腐可笑的	camp
王国的	royal
瑰丽的	magnificent
（设计、草图、提纲或版本）正在起草中的	draft
假想的	straw
继承的	successive
相当的	corresponding	equivalent	proper	comparative
左舷的	port
期中的	interim
不著名的	obscure
权威的	cathedral	important
称心如意的	eligible
缜密思考过的	thoughtful
[数]变量的	variable
流露出忧虑的	anxious
内阁的	cabinet
[乐]小调的	minor
冒充的	fake
干练的	able
不间断的	continual
猜疑的	jealous	suspicious
独一无二的	unique	alone
已过时的	obsolete
过多的	superfluous	excessive
有关美的	aesthetic
外交上的	diplomatic
富足的	flush	affluent
（机会）宝贵的	golden
威严的	August
彻头彻尾的	thorough
冒昧的	familiar
麦秆的	straw
横向的	lateral
号称的	so-called
依赖的	dependent
不可或缺的	must
分支的	offset
清楚的	crystal	clear	distinct	explicit	intelligible
粗心大意的	reckless
同伴的	fellow
二手的	used
包括的	inclusive
（风光）明媚的	glad
最小的	least	minimum
冷的	chill
巧妙的	happy	sly	subtle
医药的	medical
仓促的	snap	sudden
羞耻的	ashamed
（学术	academic
胆大妄为	reckless
易怒的	cross
孩子的	baby
失去知觉的	cold
旁边的	side
艳丽的	gay	gorgeous
极为盛行的	epidemic
使人伤心的	sore
莽撞的	bold
尖的	acute
背部的	back
斜裁的	bias
不动的	put	stationary	sticky	still
改革的	reform
冠军的	title
怀疑性的	skeptical
向上的	up	upward
热烈的	enthusiastic	strenuous	intense
耳的	aural
海边的	seaside
总括的	blanket
不熟悉的	stranger
助手	secondary
勤勉的	diligent
[废语]适当的	convenient
高贵的	magnificent	royal
厚的	thick
等积的	equivalent
私人的	personal	private	intimate
连贯的	consecutive
脚的	pedal
粗大的	thick
田园的	rural
石制的	stone
一闪而过的	flash
幻术的	magic
（与复数名词和复数动词连用）有些	few
[数]可分解的	composite
大红色的	cardinal
外国的	foreign	strange	alien	external
独自的	alone	solitary
不常见的	unusual
有移动力的	locomotive
不理智的	crazy
日常的	daily	everyday	household	routine
沉稳[持重]的	stable
不像是真的	unlikely
难处理的	problem	reluctant
可以解决的	soluble
公共的	open	public
[计]智能的	intelligent
家喻户晓的	household
强求的	urgent
微暗的	dusk
易…的	liable
审美的	aesthetic
将昏倒似的	faint
有用的	useful
骗得信任的	confidence
中古的	medieval
阴沉的	solemn
有毛病的	wrong
同属一个时期的	contemporary
民间的	folk
[免疫学]特效的	specific
两国（或以上）国家的	international
相互有关的	relative
便于使用的	handy
具有审美趣味的	aesthetic
有历史影响的	historic
手抄的	manuscript
同时的	simultaneous
专门（技术）的	technical
纤弱的	delicate	tender
寒冷的	bleak	cold
可悲的	sad
似松的	pine
准备好的	ready
深的	deep
粗鄙的	coarse
[生]已废退的	obsolete
活跃的	active
装满的	full
照惯例的	customary
总的	chief	general	gross
前面的	front	preceding
阴影的	shadow
（医院等）院外的	outdoor
巨额的	vast
优雅的	graceful
（政治上）急进的	extreme
粉红色的	pink	rose
批评的	critical
正常的	natural	normal	ordinary	proper	right
另一的	another
聚会的	party
绝望的	desperate
表面（上）的	superficial
手头的	visible
远离的	off	remote	distant
相容的	compatible
过去的	over	past
有形成力的	plastic
内部的	inner	inside	interior	internal	intimate	inward
畸形的	abnormal
绕行的	circular
祖传的	descendant
必然的	certain	necessary
高的	high	per
傲慢的	arrogant	lofty	proud
冷静的	cool	sober
心灵的	spiritual
最新的	up-to-date
小音阶的	minor
能容忍的	patient
较年幼的	junior	kid
恼火的	sore
心爱的	bosom	honey
精神的	mental	spiritual	inner
（两个中的）另一个	other
<美>毕业了的	graduate
电子操纵的	electronic
害臊的	ashamed
引起头晕的	dizzy
内地的	upper	inland	interior
[生化]抑制酶作用的	competitive
独奏的	solo
〈美〉社论的	editorial
骄	arrogant
摇滚音乐的	beat
最合适的	best
盘旋上升的	spiral
沙漠的	desert
帝王的	purple
如凶杀）	black
（有）海军的	naval
急迫的	urgent
红宝石色的	ruby
尊严的	August
张开的	spread
戏剧性的	dramatic
易于…的	apt	prone
已往的	ancient
东拼西凑的	scratch
绷紧的	tight
领养的	foster
柠檬色的	lemon
多产的	productive
不顾后果的	rash
流利的	fluent
出名的	famous	well-known
最适当的	only
呆板的	blunt	dead	mechanical	stiff	wooden
决定性的	critical	crucial	decisive	final	material
忧郁的	blue	dark
用电子设备生产的	electronic
智力的	intellectual
学术（上）的	technical
欺骗（性）的	funny
裂开的	split
糟糕的	awful	sad
方式上的	formal
很多的	great	numerous	plenty	plenty
薄的	thin
自豪的	proud
解析的	analytic
对应的	corresponding
预定	due
实质性的	relevant
吉利的	fortunate
化石的	fossil
军事行动的	operational
精通的	master	perfect
胖的	fat
化学的	chemical
原版的	master
大方的	big	generous	handsome
显赫	impressive
应用科学的	scientific
忽忽	restless
不变的	permanent	regular	set	static	stationary	steady
略带左翼政治观点的	pink
不稳定的	uneasy
异想天开的	fantastic
训练有素的	crack
胡枝扯叶	ridiculous
到期（应该支付）的	mature
普遍的	general	standard	universal	wide	widespread
收费的	pay
实质上的	virtual
[植]笔直的	strict
有技能的	skilled
严肃的	serious	solemn	stern
意志薄弱的	mental
口服的	oral
收费合理的	budget
不同的	different	otherwise	several	unlike	diverse
水下的	submarine
创记录的	record
毁灭性的	destructive	fatal
不调和	jazz
苗条的	slender	slim	trim
强制的	necessary
异国的	exotic
工业的	industrial
向外的	outward
民主的	democratic
斜的	bias
大致的	general
被关押的	captive
政治上无发言权的	dumb
通俗的	common	pop	popular
手巧的	handy
楼下的	downstairs	low
针的	pin
原子能的	nuclear
珍贵的	precious
淘气的	arch	sly	wicked
至高无上的	sovereign
必须穿戴的	regulation
非正总会发生的	inevitable
从事工业的	industrial
[光]相干的	coherent
（衣服、音乐等方面）时髦的	hip
[物]广延的	extensive
帆布制的	canvas
纪实的	documentary
[神]赎罪的	satisfactory
似砖的	brick
得之（或来自）书本的	book
[法]无偿的	voluntary
易转换成现款的	liquid
数学的	mathematical
破产的	bankrupt
司法的	judicial
不幸的	evil	wretched
无效的	empty	feeble	frustrate	void	futile	invalid
经过浓缩的	concentrate
紧张不安的	nervous
思维敏捷的	alert
良好的	prosperous	well
在先的	precedent
[口语]流行的	in
自助餐的	buffet
（动作、设计、音乐等）流畅优美的	fluid
空气的	aerial
同高的	flush
象征的	indicative
[生]群体的	colonial
市民的	civil
[法]审讯的	trial
轮流的	alternate
整数的	round
不许的	no
不易为视线所见的	invisible
美丽动人的	gorgeous
乐于助人的	forthcoming
新到的	new
人本性的	human
齐次的	homogeneous
可繁殖的	fertile
颜色会变化的	shot
爱惜的	jealous
多种多样的	diverse
银白色的	silver
指挥	conduct
赶时髦的	hip
亚麻的	linen
必然发生的事	inevitable
致死的	deadly
自愿的	voluntary	volunteer	willing
爱国的	patriotic
最先的	premier
雄健	energetic
不动摇的	resolute	stern
令人焦虑的	anxious
晚上的	overnight
细小的	slight
正确的	correct	faithful	just	right	perfect	true
在室内使用的	indoor
晕眩的	stupid
照顾孤儿的	foster
有帮助的	friendly	useful	assistant	instrumental	instrumental
党派的	party
一贯的	consistent	systematic
有宗教性质的	sacred
精明的	prudent	prudent	shrewd
远的	far
[植]根生的	radical
[色彩]青灰色的	steel
不可胜数	innumerable
等于零的	null
直截了当的	straightforward
铁的	irony
十二的	twelve
多股的	multiply
乏味的	fade	stupid
有大理石花纹的	marble
冷色的	cold
非职业的	amateur
（尤指）有钱人常光顾的	fashionable
补偿的	saving
有可能的	potential
大量的	bulk	extravagant	heavy	massive	much	vast	volume	abundant	healthy
任性的	arbitrary	contrary
[艺]有冷感的	cold
不经常的	occasional
热心家务的	domestic
保热的	thermal
领先的	banner	lead
传统式样的	classic
令人恐惧的	scare
贱的	base
卑鄙的	base	mean	miserable	reptile	shabby	wretched	petty
小…	minor
右旋的	clockwise
耐用的	durable	service	sturdy
选举的	constituent
迷你的	pocket
巍峨的	lofty
无生气的	limp
庞大的	enormous	flash	gigantic	huge	monster
勉强的	reluctant
人身攻击的	personal
加有香料的	spicy
旅行的	locomotive
可靠的	reliable	solid	authentic
精于盘算的	shrewd
有立体感的	stereo
沉默的	dumb	silent
闪闪发光的	orient
市制的	municipal
浪漫的	romantic
有规律的	regular
专门的	special	express
假设的	theoretical
用作贮藏所的	store
更进一步的	further
图解的	graphic
非常（好）的	remarkable
[语法学]（句子）复合的	compound
在晚上的	evening
基谐波的	fundamental
无抑扬顿挫的	monotonous
资历较浅的	junior
跑的筋疲力尽的	run
幼儿的	infant
特别的	extraordinary	particular	unique	extra
抱有希望的	hopeful
两极的	polar
有创意的	creative
亚麻布制的	linen
敬爱的	dear
创造性的	creative
人人知道的	public
[数]齐性的	homogeneous
使人眩晕的	dizzy
隐秘的	secret
[电]并联的	parallel
动力学的	dynamic
到	considerate
以草稿形式的	draft
那个	that
相关的	correlate	relative
表示特性的	characteristic
整洁的	feat	neat	tidy	trim
无数的	billion	million	infinite	innumerable
踏板的	pedal
不可避免的	necessary	imperative	inevitable
不光明的	dim	funny
为客人（或来宾）准备的的	guest
周到的	careful
局部的	local
不会有的	impossible
[数]可解的	soluble
近乎下流的	rude
消沉的	damp
即将的	ready
周期的	periodical
虔诚的	religious
复数的	plural
音调优美的	musical	musical
闲暇的	leisure
卓越的	eminent	predominant	remarkable	distinct	excellent
胜	wonderful
暴力引起的	violent
倒闭的	bankrupt
笃信宗教的	religious
可笑的	foolish	rediculous	ridiculous
辅助的	auxiliary	pilot	accessory	assistant
要打架的	aggressive
绝妙的	wonderful
正中的	middle
一点点	petty
成年人的	mature	adult
浪费的	extravagant
令人烦恼的	troublesome
值得注意的	notable	significant
又笨又可怜的	pathetic
风流的	romantic
不完全的	part
充满活力的	dynamic	energetic	lively	vigorous
满不在乎的	reckless
低年级的	junior
自杀的	suicide
作为仪式的一部分的	ritual
中级的	medium	intermediate
没有工作或不在运行的	off
和蔼可亲的	amiable
有力的	energetic	hard	male	vigorous
〈古〉漂亮的	proper
不平常的	unique
过分自信的	confident
确实的	positive	sure
持重	discreet	cautious
经典的	classical	textbook
冲动的	impulse
条理分明的	coherent
合算的	economic	economical	profitable
有抱负的	ambitious
英按物价指数变动工资的	threshold
美的	aesthetic
身材高的	tall
马克思主义的	Marxist
易受伤的	vulnerable
（药）有效地	powerful
供思考的	think
一场空	futile
积分的	integral
仿制的	mock	pretend
个别的	different	various	individual
用力的	strenuous
出殡时的	funeral
专有的	several	sole
引起兴趣的	interesting
无双亲的	orphan
谦逊的	humble	modest
急躁的	sudden
顽抗的	reluctant
传教（士）的	missionary
三部分的	triple
某一时间的	sometime
迟到的	late
无动于衷的	numb
错综复杂的	intricate
勇敢的	bold	brave
夸张的	camp	heroic	steep	tall
常有的	usual
黑暗的	brown	dark	gloomy
强大的	formidable	powerful
前景黯淡的	gloomy
瓷制的	porcelain
凶猛的	fierce	savage	vicious
打有活结的	slip
侥幸的	fortunate	lucky	scratch
有智力的	intelligent
值得拥有的	desirable
奶制的	dairy
溢出的	overflow
冷漠的	chill	passive	distant
恶名昭著	notorious
未受损伤的	intact
口正派的	christian
用以发射导弹的	missile
十二个的	twelve
阳性的	masculine
最前面的	foremost
感到厌倦的	weary
像智者的	wise
变化多的	diverse
邻近的	neighbor	adjacent
浓的	thick
下降的	descendant
大众的	popular
反抗的	rebel
某一个的	one
客人的	guest
软弱的	faint	weak
朝内的	in
最好的	only	prime
墙壁的	wall
灵巧的	apt	clever	feat	neat	skillful	ingenious
自然形态的	found
（举止言谈）符合公认准则的	correct
极大的	awful	huge	tremendous	infinite
富有经验的	sophisticated
世俗的	lay
容貌	bizarre
坚忍不拔的	iron
精彩的	wonderful
方灵活的	sly
大部分的	most
蘑菇的	mushroom
每月的	monthly
（字母）不发音的	mute
储存的	store
邪门儿	abnormal
黑玉制的或黑玉似的	jet
礼节性的	ritual
低的	low
乡村的	country
否认的	negative
心甘情愿的	content	willing
自负的	vain
不拘泥的	liberal
微妙的	delicate	subtle
多样的	multiply
常设的	permanent
值得做某事	worthy
理应获奖的	prize
引起恐慌的	scare
易弯的	limp
古怪的	eccentric	fantastic	odd	peculiar	queer	strange	funny
一切的	all
不隐瞒的	explicit
极好的	beautiful	capital	fabulous	famous	fantastic	glorious	gorgeous	sovereign	super	superb	terrific	tremendous	wonderful	divine
淡红色的	pink
三十的	thirty
财经家的	financial
常备的	stock
超重的	excess
级别或职位较低的	subordinate
水晶的	crystal
情愿的	ready
晦暗的	opaque
（某方向的）最远的	far	farther
在商店能买到的	store
阴天的	cloudy
结构复杂的	complicated
演变的	genetic
滑溜的	slippery
复式的	duplicate
同情的	sympathetic
美秋天的	fall
草拟的	draft
神的	divine
有眉有眼	plausible
没有出息的	futile
显而易见的	conspicuous	gross	noticeable	transparent
没有指望的	bleak
〈美〉文科的	academic
令人沮丧的	gloomy
〈口〉有点醉意的	happy
正直的	upright
相投合的	sympathetic
需要体力的	robust
与…结为夫妻的	married
三的	three
革命的	revolutionary
孤单的	lonely
高耸的	dominant	lofty
（结构）复杂的	elaborate
便宜的	budget	cheap
蒸发的	vapour
逐日的	day
快速的	fleet	rapid	lightning
款式等）	bizarre
可移动的	mobile
供盲人用的	blind
关键的	key
言语的	verbal
最远的	utmost
形容词的	adjective
善于叙述的	narrative
浇铸的	run
性感的	desirable
担心的	fearful	afraid
无条件的	absolute
共和主义的	republican
平易的	popular
（美）有进取心的	aggressive
较不重要的	less
纯真的	pure
起作用的	effective	active	instrumental	instrumental
脆弱的	tender
自夸的	vapour
情绪异常激动的	hysterical
心智健全的	sane
造型的	plastic
自动的	automatic
无可胜数	innumerable
通话完毕	through
比赛的	competitive
高亢的	loud
博学的	learned	wise
权力的	power
（性质和特征上）不显著的	dim
诚恳的	cordial
可保存的	cabinet
左边的	left
编辑的	editorial
贪婪的	greedy
喜爱的	favorite
[生]向性的	tropic
粗糙的	coarse	crude	harsh	mat	rough
嘈杂的	noisy
责无旁贷的	indispensable
有益健康的	wholesome
困难的	difficult	hard	tough
如此的	so	such
不公正的	wrong
才华横溢的	brilliant
有信心的	confident
流动的	fluid
华丽的	brave	gay	gorgeous	magnificent	superb
有闯劲的	aggressive
定量的	quantitative
好怀疑的	skeptical
含金的	gold
不在场的	absent
适中的	modest
现货的	spot
强横的	turbulent
女儿般的	daughter
（风、光线）来自西北方的	northwest
玄妙	mysterious
正好相反的	polar
单独的	separate	sole	solo	alone	exclusive
陈旧的	stock	tired
临界的	marginal
湿气重的	humid
每月一次的	monthly
休眠的	asleep	latent
[解剖]体内的	intrinsic
充满欢乐的	glad
作为结果而发生的	subsequent
累赘的	diffuse	redundant
复合	compound
热切的	eager
用电子设备完成的	electronic
大头针的	pin
概略的	skeleton
有人性的	human
分离的	apart	separate	split	isolate
[数学]（顶、边等）对的	opposite
张大的	wide
普遍发生的	prevalent
应得某事物	worthy
新生的	orient
坚强的	steel	strong	tough	iron
后来的	later	subsequent	after
未成熟的	green	adolescent
（俚）过分的	tall
雄性的	male	masculine
拉丁美洲的	Latin
[体]违反规则的	foul
慢于…的	slow
同性质的	homogeneous
策略的	diplomatic
低洼的	low
兴隆的	brisk
紫外线的	ultraviolet
知识渊博的	profound
突起的	prominent
直系的	direct
光荣的	honorable	proud
正式的	official	proper	state
保存的	saving
〈美俚〉自以为了不得的	popular
进行中的	toward
复制的	duplicate
愚钝的	weak	dense
（尤指）有美术才能的	artistic
好奇的	curious
全的	per
现实的	real	realistic
配得上的	worthy
攻势的	offensive	aggressive
大规模的	mass	massive
（景色）美丽的	glad
小型的	miniature	baby
肌肉发达的	muscular
“bad“以及“ill“的最高级	worst
不断的	constant	perpetual
高级的	high	exclusive
惯常的	systematic
轻快的	brisk
执行的	executive
合适的	correct	eligible	feat	fit	meet	right	suitable	appropriate
假名的	anonymous
肉欲的	animal
用数字表示的	numerical
再一个	another
温热的	thermal
无疑的	moral	sure
钢制的	steel
[语]加强语意的	intensive
怕人	timid
其他一种	another
包罗广泛的	inclusive
二十的	twenty
[医]良性的	benign
满足的	content
渗透的	saturate	shot
法律（上）的	legal
内侧的	inside
较老的	elderly
整齐的	clean	orderly	regular	smart	so	straight	tidy	trim
能共处的	compatible
可理解的	intelligible
详述的	explicit
目前的	present	instant
即食的	instant
白种人的	white
向西北的	northwest
凸出的	outstanding
附加的	auxiliary	fringe	more	plus	accessory	additional	extra
起源的	genetic
（与某些代养有关的名词连用）	foster
民用的	civil	civilian
可以解释的	soluble
在使用中的	living
收入仅敷支出的	marginal
下游的	lower
古典文学的	classical
出局的	out
安逸的	comfortable
教会的	church
羞手羞脚	timid
[游戏]复局的	duplicate
[美国英语]退伍军人的	veteran
下层的	underlying
固结成的	concrete
英领殖民地时期的	colonial
（价格等）有竞争力的	competitive
直竖的	erect
王室的	household	royal
刺耳的	harsh
难实行的（计划等）	romantic
短缺的	short
极地的	polar
奇妙的	curious	wonder
排山倒海	gigantic
最不重要的	least
强壮的	muscular	strong	sturdy	tough
湿润的	humid
马的	horse
原封不动的	intact
令人厌倦[生厌	weary
（果实等）早熟的	early
创造的	creative
狂暴的	must	rough	rude	violent
优胜的	champion
市内	urban
选修科目	optional
成人的	grown-up
以观察或实验为依据的	empirical
通过单独的若干阶段来发展	linear
起因的	genetic
有望获奖的	prize
持久的	durable	permanent	stable
不明事理的	silly
（体格）结实的	compact
制作精巧的	skillful
病人用的	invalid
飘飘然	drunk
搞业余无线电收发报的	ham
（在君主等）统治下的	subject
催促的	urgent
后座后面有较大的空间）	estate
早期的	early
四十的	forty
双重的	twin
易受批评的	vulnerable
秋季的	autumn	fall
向东方的	east
斜向一边的	sideways
五的	five
浅色的	pale
共和国的	republican
不舒服的	bad	sick	uneasy	funny
天生	inherent
[体育]1)。在田赛场地进行的2)。田赛的	field
宽的	loose	wide	broad
已婚的	married
弄虚作假的	trick
巨人似的	gigantic
外面的	out	outer	outward	over	exterior	external
浸透的	saturate
与众不同的	unusual
魔术的	magic
实在的	concrete	effective
跌价的	bear
盲目的	blind
直接的	direct	intimate
一流的	boss	cool	crack
向后的	backward
混合成的	composite
尝试性的	tentative
忠贞的	loyal
内在的	resident	inherent	intrinsic
不愿听的	deaf
时常发生的	frequent	periodical
盘错	intricate
别的	else	other	otherwise
牧场的	range
优越的	signal	exceptional
危急的	critical
松木制的	deal
有毒的	poison	poisonous	toxic
专横的	arbitrary	imperative
罕见的	rare	scarce
相互的	mutual	reciprocal
近的	near
理论的	theoretical
朦胧的	cloudy	obscure
开拓的	frontier
有实力的	substantial
抽象的	abstract
在西方的	west
（皮毛、发、羽）呈褐色的	brown
难得的	unusual
端庄的	modest
武断的	arbitrary
木头的	wooden
平等的	equal	even
无论怎样…都	whatever
国际的	international
似铁的	irony
裸露的	naked
阴冷的	grim
血统纯粹的	genuine
灾难性的	disastrous
令人讨厌的	nasty	troublesome
垮了的	bankrupt
手制的	manual
肝味的	liver
迷惑人的	catch
可实行的	feasible
有价值的	valuable	worthwhile
不相容的	alien
北部的	north	northern
辣的	hot
确定的	firm
公开的	open	outward	public
天然的	crude
挖苦的	sarcastic
青铜色的	bronze
发展水平低的	primitive
透视的	perspective
如死一般的	deadly
含义清楚的	transparent
（宝石）密镶的	pave
[化	bound	polar
（分期付款）最后一笔大数目的	balloon
用带子绑住的	bound
鬼鬼祟祟的	sneak
平缓的	gradual
混凝土制的	concrete
没有经验的	lay	maiden
[植]下位的	inferior
完好无缺	intact
（肉体）疼的	painful
香的	fragrant	spicy
不适的	queer
清淡的	slack
商业的	commercial	merchant
隐匿的	invisible
害怕	afraid
连载的	serial
松（弛）的	slack
空中的	aerial
奢侈的	extravagant	superfluous
自满的	ham
有说明力的	eloquent
服务性的	service
头昏眼花的	dizzy
颠倒的	reverse	wrong
浮华的	flash
成直角的	square
凶恶的	fell
第三的	third
平行的	parallel
左派的	left
救济院内的	indoor
琐碎的	little	trivial	futile
照常的	ordinary
（儿童）尿湿尿布的	wet
流行的	current	fashionable	popular	prevalent
环行的	circular
有机（体）的	organic
应付的	owing
最好的(good和well的最高级)	best
淡薄的	thin	weak
急切的	desperate
医学的	medical
汹涌的	rough
物]结合的	bound
卑劣的	dirty	small	insect
音频的	audio
毫无价值的	regardless
在底部的	lower
不结实的	slight
复杂难懂的	clumsy
[生]种的	trivial
男性化的	masculine
经营的	operational
深深地充满着	instinct
用乐器演奏的	instrumental
注意的	alert
略胜一筹的	preferable
有吸引力的	magnetic	magnetic
极小的	minute	tiny
平的	flat	plain	plane
有生气的	active	alive
交际的	social
远端的	far
国民间的	civil
节日的	festival
钢铁业的	steel
无光泽的	mat	opaque
栗色的	bay
衰弱的	feeble
宽容的	tolerant	understanding
周末的	weekend
失常的	wrong
缺少的	absent
可翻下的	turnover
黑人的	Negro
至高的	supreme
钝的	blunt	dull
连环画的	comic
犹豫不决的	dubious
率直的	direct	naked
攻击的	offensive
〈美〉用过的	used
容易接受的	recipient
来自东方的	eastern
讨厌的	grim	military	offensive	painful	rank
恶意的	malignant	poisonous
[植]相近但不连接的	approximate
正确无误的	accurate
慎重	considerate
倒转的	inverse
盛大的	royal
橙色的	orange
为首的	banner
现金的	cash
令人关注的	interesting
困乏的	weary
倾斜的	bias	prone
常驻的	resident
野生的	wild
（社会、政治）进步的	forward
恰好是	very
忍受的	tolerant
消极的	negative	passive
气球状的	balloon
沮丧的	blue	damp	down	low
丰盛的	generous	superb
不规则的	abnormal
固定的	put	set	stationary
高兴的	glad
固执的	stubborn
不中用的	weak
爽快的	crisp
精密	precise
幸福的	happy	prosperous
天气等）安静的	calm
对…不耐烦的	tired
靠广告收入的	commercial
有效率的	efficient
Z字形的	zigzag
日光的	solar
口述的	oral
有经济效益的	economic
法庭的	judicial
[医]阳性的	positive
轻的	light
手指的	digital
渴望得到	hungry
最高级的	summit
轻松的	soft
非常有效的	deadly
高价的	rich
美国黑人文化的	soul
四季开花的	perpetual
飘飘然的	happy
东方的	east	eastern	orient	oriental
电的	electric
不正确的	erroneous	wrong
爆炸等）猛烈的	violent
多重的	multiple
单纯的	naive	pure	simple
枯竭的	bankrupt
致命的	deadly	fatal	kill	malignant	mortal
安心的	secure
从东方来的	east
各种的	all
未必可能的	incredible
料不到的	unexpected
圣徒般的	holy
互惠的	reciprocal
没有的	no
[S-]石器时代的	stone
在前的	former	precedent	preceding
国际关系的	international
国内的	domestic	inland	interior	internal
碳处理的	carbon
迷人的	attractive	darling
桔红色的	orange
用桃子制成的	peach
即将来到的	toward
持续的	constant
清楚表明的	frank
暧昧的	dubious	vague
有自尊心的	proud
精疲力尽的	used
经常	everyday
缺席的	absent
（规则、方法等）死板的	rigid
爱管闲事的	busy
活泼的	bright	lively	pat	alert	alive
拼花的	mosaic
用砖做的	brick
清晰的	plain	precise	clear
[艺]现实主义的	realistic
实地的	field
野蛮的	brutal	savage	wild
分居的	separate
几乎垂直地	sheer
欺诈的	confidence	trick
即刻的	summary	instantaneous
后方的	hinder
剧烈的	severe	violent	acute	exquisite
参谋的	staff
厌世的	pessimistic
有辐射部分的	rotate
非常	very
当地的	local
腐败的	corrupt
独占的	several	sole
许多的	fifty	hundred	much	numerous	various
夏季的	summer
宽裕的	easy
刚毅的	resolute
兴高采烈的	glad	jolly
朝东的	eastern
被弄翻的	upset
<美>最高年级的	senior
热情洋溢的	eager
大理石的	marble
大调的	major
糊涂的	silly
[法]可享受利益的	beneficial
（衣着）短的	brief
绿色的	green
极好的或令人满意的	splendid
以后的	later	after
少年的	juvenile
慷慨的	generous	handsome	liberal
内科的	medical
可为(X光等)透射的	transparent
在东北的	northeast
可接受的	possible
较劣的	less
秘密的	cabinet	closet	confidential	private	secret	underground	inner	interior
平稳的	equal	level
头脑清醒的	sober
潜意识的	latent
人造的	artificial	synthetic
充分的	thorough	wealthy
教导道德的	moral
声音尖利的	brittle
不相关连的	independent
敌对的	hostile	opponent	sour
一度的	sometime
令人愉快的	gorgeous	grateful	lovely	pleasant	agreeable
对…有兴趣的	game
冷气等）感觉得到的	conscious
[逻]外延的	extensive
普通百姓的	folk
中世纪的	medieval
常规的	routine
青少年的	adolescent
（在）国外的	overseas
电视的	video
〈古〉一流的	famous
晚期的	terminal	advanced
幼稚的	juvenile	juvenile	naive	infant
学术上的	learned
认识的	cognitive
绝对的	mathematical	sheer	strict	thorough	total	utter	absolute	implicit
乐观主义的	optimistic
未填写的	blank
工艺的	technical
难做的	difficult
万能的	universal
排外的	exclusive
电气设备阴的	female
杂乱无章的	absurd
（风）来自西面的	west
举起的	up
兴奋的	cordial
招人喜爱的	attractive
用工业方法制造的	technical
机械能的	power
对立的	contrary	opponent	opposite
补充	additional
适合的	fitting	likely	agreeable
危险的	critical	dangerous	serious
明摆着的	patent
[美国俚语]真棒	fancy
聋的	deaf
损失惨重的	disastrous
任意的	free	optional	random
含盐的	salt
（级别、地位）较高的	superior
静电的	static
适当的	applicable	apt	due	fitting	meet	pat	proper	reasonable	suitable	adequate	advisable	appropriate
保守的	conservative
芳菲	fragrant
作为标志的	token
美共和党员	republican
极妙的	fabulous
恰好的	pat
被热爱的	beloved
明确的	definite	specific	straightforward	clear	explicit	express
令人激动的	electric	electrical	exciting
浅薄的	technical
显然的	apparent	visible
胆怯的	chicken	fearful	yellow
虚假的	artificial	mock	sham
（男子）女人腔的	camp
适合于成人的	grown-up
直陈的	indicative
褐色的	brown
航空的	aerial
乐器的	instrumental
疲倦的	tired	weary
博识的	read	wise
完善的	thorough
贪心的	greedy
负有责任的	responsible
惊动一时的	spectacular
初步画出或（写出）的	draft
拾得的	found
[光]入射的	incident
光学的	optical	visual	visual
[口]微醉的	merry
敌人的	enemy	hostile
难对付的	awkward	tender
小说般的	romantic
极其显要的	crucial
用电的	electrical
[物]组合的	resultant
替换用的	spare
言语或行动空洞的	empty
彻底的	radical	thorough	utter
八十岁的	eighty
不能成立的	invalid
船的	naval
状态）的	situated
产业的	industrial
[数学]公共的	common
苍白的	pale
早的	early
留存下的	remainder
机密的	confidential	secret
皮毛的	shallow
相称的	fitting	worthy
占主导地位的	predominant
距离的	metric
（用于指称被替代的东西）原来的	old
锋利的	sharp
小规模的	petty
忠顺的	obedient
有区别的	distinct
令人满意的	desirable	satisfactory	useful
又一个	another
引起争议的	controversial
当选而尚未就职的	elect
生死攸关的	vital
胡乱的	random
官气十足	official
加了蜜的	honey
形象化的	visual
肥胖的	round
[商]即期付款的	prompt
同情况的	fellow
[物]基频的	fundamental
彼此的	mutual
善于表达的	articulate
真心实意的	sincere
小的	little	mere	pocket	small	petty
偷偷摸摸的	hedge	sly	sneak
纸制的	paper
清白的	innocent
〈古〉纯粹的	sincere
模棱两可	ambiguous
严厉的	dear	grim	harsh	severe	stern	stiff
抵抗的	resistant
一家所有的	family
时机成熟的	ripe
假造的	false
感谢的	grateful
恶化的	worse
（水	shallow
平均的	average	level	medium
牛奶的	dairy
在上的	over
协助的	cooperative
可尊敬的	worthy
更多的	more	further
空谈的	closet	academic
有义务的	bound	liable
受崇敬的	sacred
无知的	dark	innocent
悼念的	memorial
无损的	safe	sound
头衔的	title
纪念的	memorial
铤而走险的	desperate
（农业方法）集约的	intensive
有形的	concrete
亲近的	close	intimate
机械的	mechanical
旋转的	revolutionary	rotary
常存于内存中的	resident
果实累累的	fruitful
带来幸运的	fortunate
[航]（船上）应急用的	jury
最权威的	net
突出的	eminent	prominent
副手	secondary
临界值的	threshold
有恶意的	vicious
感觉的	sensitive
讽刺的	sarcastic
宝贝的	precious
晕船	sick
独唱的	solo
男子气概的	masculine
快餐式的	buffet
有亲属关系的	kin
满意的	content
无党派的	independent
不顾虑的	regardless
有争议的	controversial
使用马力的	horse
全球的	global
口头上的	lip
伟大的	giant	great	magnificent
特大的	giant	extra
不讲理的	brutal
口无神论的	skeptical
极其的	terrific
变化的	mobile	variable
没喝醉的	sober
现任的	now
实用的	convenient	practical
来自南方的	southern
博览的	read
退化的	degenerate
（男子）英俊的	handsome
当然的	moral
由于	due
一周一次的[地]	weekly
（孩子等）难管的	troublesome
（房间、柜子等）空的	bare
热诚的	cordial
精通某门学问的	learned
无期限的	perpetual
做作的	ham
同事的	fellow
已包括在价款[租金等]之内的	found
有组织的	orderly	organic	organization
经历充沛的	live
[解]头顶的	vertical
强制性的	compulsory
完好的	sound
令人享受的	gorgeous
温暖的	mild	warm
引起惊异的	marvelous
浪漫主义的	romantic
基于史实的	historical
交战中的	militant
〈英〉（对房客等）不另加费供应的	found
基础的	fundamental	underlying
虚弱的	feeble	weak	fragile
仔细考虑过的	mature
更可取的	preferable
很恰当的	lucky
冷杉木制的	deal
综合的	comprehensive	general	overall	integrate
（尤指在生意上）公平的	square
同等级的	coordinate
肌肉的	muscular
优质的	oriental	quality
有议论余地的	open
非法的	false
闪光的	flash
不能相信的	impossible
拣到的	found
明亮的	bright	brilliant	clear
一年一度的	yearly
素的	plain
朝北的	north
先进的	advanced
容易的	easy	snap
初期的	infant
[语法学]并列的	coordinate
不普通的	unusual
空缺的	vacant
感到伤心的	sorry
显见	apparent
常备军的	stationary
（思想上）不清楚的	vague
能耐…的	tolerant
铁制的	iron
不新鲜的	off	stale
为众人所推崇的	splendid
版权的	copyright
懈怠的	slack
不知名的	nowhere
给人以希望的	hopeful
选出的	elect
可鄙的	cheap
之字形的	zigzag
资深的	senior	veteran
团结一致的	solidary
（建筑物）巍峨的	monster
畅快的	cosy
机动的	locomotive
三方的	triple
无名的	anonymous	obscure
天赋的	born	natural
半信半疑的	dubious
（文艺作品等）找到的	found
由市场内部因素（如投机等）引起的	technical
能胜任的	capable	competent	sufficient
荷	grateful
用防水材料处理过的	waterproof
坐落在…的	situated
自由的	free	liberal	loose	quit
为…所爱的	beloved
令人容易上当的	catch
和蔼的	gracious
非常精确的	thorough
多方面的	various
吉祥的	lucky
冰淇淋的	ice-cream
粘性的	sticky
早日的	early
有关历史研究的	historical
风雅的	artistic
乖巧的	bright
严格意义上的	proper
合群的	social
有洞的	through
合作的	cooperative
努力的	hard
下面的	under	underneath
喷香	delicious	fragrant
[计]并行的	parallel
盈满的	flush
合身的	fit
习惯性的	chronic
表示信任的	confidential
非正式的	casual	shadow	associate
有意识的	conscious
喜欢户外活动的	outdoor
看不见的	invisible
沉醉	drunk
权力大的	powerful
被监禁的	captive
间隔的	alternate
[摄]感光快的	rapid
优美的	graceful	proper	exquisite
专利的	patent
洪亮的	loud
市营的	municipal
丰满的	fat	round
不诚实的	mock
大学生的	undergraduate
在孤单中度过的	lonely
[法]附带的	incident
逐渐的	gradual
美妙	wonderful
孕育着…的	pregnant
二倍的	duplicate
平坦的	plane
用旧了的	used
精神健全的	normal
无力的	limp	pale	weak
失去理智的	wood
年老的	ancient	advanced
有无上权力或权威的	absolute
革新的	renovate
里面的	wrong	inside
行动精确的	precision
自己的	own
公平的	cricket	even	fair
乐观的	optimistic
[哲]客观外界的	outer
表示亲昵的	pet
语言的	linguistic
激烈的	drastic	heavy	loud	furious
简陋的	crude	humble	rude	spare
构成的	component	constituent
边疆的	frontier
外交的	foreign
能防范	proof
九十岁的	ninety
血一样的	bloody
贵重的	precious	valuable
两个的	two
不引人注目的	invisible
强烈的	deep	strong	intense	intensive	keen
私下的	closet
令人敬畏的	August	formidable
秋天的	autumn
中肯的	relevant
一致的	conform	consistent	corresponding	even	agreeable
声名狼藉的	notorious
激愤	indignant
根据命令（或要求）而作的	command
知道的	aware
〈古〉有能力的	sufficient
金钱的	monetary
多疑的	suspicious
[地]全新世的	recent
（文献等）错误百出的	corrupt
特种的	specific
充足的	ample	competent	enough	sufficient	abundant
共有的	common	mutual	party
古老的	ancient	antique	old
突然发生的	swift
合乎卫生的	wholesome
[语法学]现在时的	present
由零碎（或废料）组成的	scrap
低微的	mean
家内的	household
诚实的	honest	upright
适宜的	fitting	suitable
中断的	disrupt
各个的	several	various
弯曲的	curve
相当大（或多）的	considerable
[地质学]基性的	basic
难为情	ashamed
地下的	underground
冬天的	winter
能干的	capable	competent	efficient
有代表性的	representative
成年的	grown-up	adult
存在或发生于种族之间的	racial
按季度的	quarterly
（指某人曾经是…）从前的	sometime
上述的	preceding	above
告别的	farewell
皮的	leather
丝绸的	silk
长的	long
睡着的	asleep
导电的	electric
具有城市或城市生活特点的	urban
无关的	irrespective
英雄的	heroic
渐（升）降的	gradual
[仅用作定语]用于发送的	send
警觉的	alert
断断续续的	intermittent
势在必行的	imperative
不错	okay
能谅解的	understanding
百分度的	centigrade
约定的	conventional
引起歧义的	ambiguous
阴暗的	dull
一向的	usual
文书的	documentary
大陆的	mainland
生的	raw
通情达理的	sensible	understanding
无罪的	innocent
庄严的	royal	solemn	imperial
社交的	party	social
（俚语）坏透了的	shot
吸引人的	exotic
习惯的	customary	accustomed
预先的	advance
负的	minus
小孩似的	baby
铜制的	copper
自身的	onto
[心]反抗性的	negative
典型的	average	classic	model	representative	typical
无勇气的	faint
从容的	easy
失业的	redundant
善良的	benign
管理的	directory	overhead	executive
满面红光的	flush
（按照）透视画法的	perspective
空闲的（时间等）	spare
同盟的	federal
想不到的	unexpected
做事有效率的	together
（脚声等）轻软的	velvet
适于探测的	detective
不活跃的	slack
荒芜的	desert	waste
一般的	pedestrian	standard	universal	broad
陶醉的	drunk
茂密的	thick
小巧易携带的	compact
笨拙的	awkward	clumsy
俚很好的	boss
金（制）的	gold
紧张的	electrical	strenuous	intense
[植]（枝条）平层的	horizontal
[语法学]可能语气的	potential
（纸、棉布或麻布等）本色的	brown
有罪的	guilty
可以吃的	edible
简单的	simple
相貌平平的	plain
虚构的	romantic	synthetic
假冒的	tin
外围的	fringe	out
不朽的	eternal
突出地支持（某一政党）的	banner
基本的	basic	cardinal	elementary	essential	first	fundamental	king	meat	primary	prime	radical	skeleton
远程的	remote
令人感兴趣的	catch	interesting
转瞬即逝的	fleet	transient
僵痛的	lame
随后的	subsequent
社交界的	society
过了中年的	elderly
副的	auxiliary	deputy	side	vice	assistant
分散的	disperse
上等的	choice	fine	superior
节省的	saving
哪一个	which
倒开的	reverse
根本的	fundamental	organic	radical	thorough
十一个的	eleven
无限的	infinite
娇小的	little
油腔滑调的	clever
成功的	successful
（宝石）扁薄发光的	spread
坚定的	decisive	firm	robust	steady	stern	sturdy
愚笨的	mental
阜	abundant
有缺点的	faulty	vicious
重型的	heavy
象炭一般黑的	jet
优异的	great
一年的	annual
广大的	ample	extensive
犯罪的	criminal
提供保护的	safe
幽默的	humorous
中央的	middle
出色的	class
不说话的	dumb
分开的	separate
舒适的	comfortable	cosy	easy
留意堤防的	jealous
破灭的	extinct
静止的	silent	static	stationary	still
黑色的（以幽默的方式对待讨厌的或可怕的事物	black
融化的	run
具有艺术性的	art
（汽车）连箱的（拥有较长的车身和后门	estate
政治的	political
粗俗的	gross	naughty	vulgar	broad
转化的	invert
先行的	advance
任何的	any
计算机或计算机系统停机	down
末期的	late	terminal
散漫的	loose
生疏的	strange
(many)的比较级	more
连衣裙的	dress
无趣味的	dry
现场直播的	live
小体型品种的	toy
牙齿的	dental
香艳的	romantic
新近的	recent
未付的	owing
（用于）操作的	operational
进行的	progressive
残忍的	bloody	bloody	brutal	cruel	fell	fierce	grim	ruthless	savage
无结果的	vain
暗中的	sly
表示可能性的	potential
风趣的	humorous
每天的	everyday
依靠的	dependent
使优美	polish
执政的	in
集体主义的	collective
〈美〉（大学文科）有关[包含]各种实习活动的	cooperative
一百的	hundred
新的	clean	fresh	new
不透明的	opaque	thick
悲惨的	disastrous	miserable	tragic	wretched
充满趣味的	lively
蓄意的	deliberate
紫色的	purple
玫瑰花的	rose
脆的	crisp	porcelain	fragile
自明	obvious
有多种学问、技能或职业的	versatile
借故生端的	aggressive
流传的	current
ill	worse
符合。。	corresponding
艰苦的	tough
不结果实的	barren
关闭的	shut
[医]异质的	foreign
研究生的	graduate
痛切的	deep
技艺高超的	crack
[数]正的	positive
酸的	acid
可能性最大的	outside
植物的	vegetable
值得的	worth
家庭的	domestic	family	home	household
有影响的	predominant	influential
费力的	painful	strenuous
该死的	damn
无足轻重的	negligible
智慧的	mental
骨瘦如柴的	skeleton
独有的	particular	accustomed
值得花时间的	worthwhile
指示的	indicative
天真的	naive	native	simple
战斗中的	militant
可看见的	apparent
深奥微妙的	sophisticated
平淡的	fade	ordinary	tame
冒犯的	offensive
头等的	top
[生物学]原生的	primitive
无论什么…都	whatever
数量庞大的数量庞大的	numerous
廉价的	cheap
显着的	eminent
产生运动的	locomotive
废弃的	obsolete	scrap	waste
历史的	historic	historical
开得很大的	wide
移动的	locomotive	mobile
独立自主的	sovereign
首位的	leading	premier
极相似的	approximate
自然的	natural	spontaneous
模范的	model
[医学]真性的	genuine
本金的	principal
化学作用的	chemical
（脸）涨红的	red
运动的	motive	sport
可观的	handsome	impressive
神圣的	holy	sacred	solemn	divine
[美国口语]大吃一惊的	beat
补充的	auxiliary	extra
不毛的	desert	hungry
玩具的	toy
有刺激性的	spicy
临时凑成的	pickup
[语言学]双唇展开的	spread
没精打采的	lazy
（年龄、地位等）同等的	peer
暴躁的	explosive
禁欲的	continent
给予帮助的	helpful
修长的	trim
橘色的	orange
下列的	following
（风	north	violent
室外	outdoor
害怕的	fearful	afraid
自然规律的	physical
过于巧合的	pat
异已的	alien
按月的	monthly
喜爱[精通]音乐的	musical	musical
干净的	neat	pure
臭名远扬的	notorious
按比较估计的	comparative
通俗风格的	pop
广阔的	spacious	vast	wide	extensive
高地的	highland
瘦的	lean	spare
合算	worthwhile
全世界的	universal	worldwide
有关警察的	police
上了年纪的	elderly
像银的	silver
这样的	such
沉闷的	damp
有才智的	intellectual
逐次	successive
普通平民的	folk
[语]表示结果的	consecutive
插播的	spot
粗糙但实用的	bush
真实的	legitimate	real	sincere	actual	true
附近的	handy
有关全球大局的	global
烤制的	roast
昆虫的	insect
〈诗〉同dusky	dusk
谈情说爱的	romantic
椭圆形的	oval
流畅的	fluent	smooth
最不可能的	last
古时制造的	antique
前述的	preceding
棘手的	awkward	stubborn
第五十周年的	golden
价格上涨的	bull
凶暴的	enormous
足够的	ample	competent	enough	plenty	sufficient	adequate
超绝	unique
容貌出众的	striking
能发出声音或语言的	vocal
难为情的	small
一些	any	some
一切开支包括在内的	inclusive
关键性的	crucial
自然（界）的	physical
唾手可得的	forthcoming
有空的	available
口人（类）的	christian
文学（上）的	literary
显著的	great	notable	noticeable	obvious	outstanding	remarkable	signal	striking
叙事体的	narrative
合格的	regular	standard
柔弱的	slender	weak
南的	south
凌厉的	quick
发电的	electric
不重视的	regardless
封建的	feudal
五十的	fifty
变暗的	dusk
沉重的	heavy
有意义的	significant
连续的	consistent	continuous	serial	straight	successive	consecutive
感光快的	fast
多个的	multiple
米制的	metric
度量衡英制的	imperial
友善的	kind	sociable
潜在的	latent	potential	underlying
滑动的	slip
流传民间的	folk
蜜的	honey
苏格兰高地的	highland
（地方）易受攻击的	vulnerable
庄重的	serious	solemn
不言明[含蓄]的	implicit
定性的	qualitative
不关心的	regardless
协调的	compatible
荡气回肠	pathetic
远离内部（中心）的	outer
老手	expert
草图的	draft
家常的	household
末捧的	anchor
恶心的	sick
射出的	radiate
家的	domestic
松木的	pine
（常大写）（英国或英联邦国家）工党的	labor
盛行的	prevalent
年少无知的	juvenile
安详的	smooth
畅所欲言的	vocal
（构思者）奇特的	fancy
有地位的	important
易被说服的	flexible
雄赳赳的	August	game
强的	strong
秕谬	erroneous
雨后蘑菇似的	mushroom
（呼吸）浅的	shallow
逐次的	gradual
平等比赛的	scratch
积极行动的	aggressive
苦的	bitter
同“self-conscious“	conscious
柔韧的	flexible
生气的	angry	crazy	mad
非凡的	extraordinary	marvelous	remarkable	singular
日间的	day
有益于健康的	healthy
这么大的	such
含糊的	dubious	opaque	ambiguous
老兵的	veteran
出生的	born
精选的	choice	elect	select
送行的	farewell
寂寞的	lonely
民族主义的	national
与电有关的	electrical
养育的	foster
劈开的	split
稀少的	thin
有意思的	meaning
年长的	senior
匮乏的	poor
简洁的	brief	compact	concise	elegant	lean
地平线的	horizontal
直达的	through
和平的	peaceful
内的	interior
刺眼的	loud
在内的	in
电子的	electronic
迅速的	forward	prompt	sudden	swift	active	express
一致同意的	unanimous
[法]有关程序的	adjective
春天的	spring
故意的	deliberate	voluntary
易受影响的	sensitive	susceptible
种族的	ethnic	racial
塑料[塑胶]的	plastic
平凡的	commonplace	garden	ordinary	trivial
大学的	undergraduate	academic
[逻辑学]（条件）必然的	sufficient
高大的	tall
令人痛苦的	miserable
[语]限定的	finite
合宜的	decent
美俚慢吞吞的	moderate
[数]有穷的	finite
让人受难的	cruel
多层的	multiply
尖锐的	bitter	sharp
（时间上）遥远的	remote
极不友好的	horrible
技术（性）的	technical
坦诚的	honest
可伸缩的	elastic	stretch
最适宜的	optimum
恶劣的	dirty	gross	nasty	wicked	wretched
民众的	popular
衍	redundant
标题的	title
壮丽的	magnificent
不孕的	barren
深思的	think
导弹的	missile
善于分析的	analytic
[物]静力的	static
定制的	custom
庶生的	base
同时代的	contemporary
没有手提带的	clutch
顽皮的	naughty	sly	wicked
劣的	base
白色的	white
社会上的	social
古风的	antique
皇家的	imperial
富裕的	ample	prosperous	rich	affluent
[语]阴性的	feminine
（为）艺术家的	art
反常的	abnormal
肌肉运动的	motor
美丽的	beautiful	fair	fairy
最大限度的	capacity
（学校教育或培训）正规的	formal
球状的	global
嗜杀的	bloody
坏的	bad
规则	regular
人为的	artificial	pat
易变的	fluid	mobile
只不过	mere
或折转的	turnover
质量的	qualitative
每一百中有…的	percent
广泛应用	widespread
从前的	former
猝发的	instantaneous
皮革的	leather
后面的	back	following	hinder	rear
特好的	bully
暖调的	warm
正突出的	singular
嗓音的	vocal
（声音）流畅的	liquid
分期偿付的	serial
爽快而清新的	brisk
有秩序的	orderly
有礼貌的	civil	gracious	polite	agreeable
带电的	electric
势不可挡的	overwhelming
职员的	staff
妒羡的	jealous
黄皮肤的	yellow
从事文学研究（或写作）的	literary
公制的	metric
不太清晰的	distant
有步骤的	systematic
貌似真实的	plausible
魔	mysterious
俱乐部的	club
海滨的	seaside
集合的	collective
不大的	humble
中等教育的	secondary
木制的	wood	wooden
用电力（或动力）发动的	power
似矿物的	mineral
政府部门的	executive
缺水的	thirsty
缺乏的	absent	scarce
犯规的	foul
愁容满面的	cloudy
最初的	first	foremost	original	prime	initial
（戏票、车票等）有效的	available
谦虚的	modest
实验的	experimental
美好的	beautiful	graceful	nice
各自的	each	respective	several
反面的	reverse
有趣的	classic	delicious	jolly	merry	pleasant	funny	interesting	interesting
恐怕	afraid
空论的	theoretical
（性质上）有密切联系的	associate
湍流的	turbulent
首要的	arch	basic	head	premier	primary	prime	ultimate
器物等）浅的	shallow
通常陈列于柜橱内的	cabinet
较远的	further
开始的	opening	initial
[语]祈使的	imperative
臭名昭著的	notorious
走了味的	stale
（光）苍白的	lunar
有感染力的	infectious
三十个的	thirty
高尚的	christian	gentle	high	lofty	magnificent	noble	proud	spiritual
囫囵	entire
奇幻	bizarre
严密的	exact	rigorous	thorough
素食者的	vegetarian
富于表情的	eloquent
品行坏的	evil
[农]精耕细作的	intensive
令人震惊的	horrible
有耐性的	patient
流体的	fluid	fluid
费尽心血的	diligent
酸性的	acid
实际的	concrete	effective	practical	actual
电动的	electric	power
基督教的	christian
不必要的	superfluous
可选择的	optional
八个的	eight
相邻	adjacent
[仪]灵敏的	sensitive
形象的	graphic
家用的	home
无说话能力的	dumb
市政的	municipal
偏（离中）心的	offset
在（法律上或道德上）合格的	eligible
（货物等）分量轻而体积大的	balloon
比较（上）的	comparative
实质的	substantial
总计的（金额等）	total
好的	better	fine	good	right
[医]急性的	acute
稠密的	thick	dense
用以吓唬人的	scare
觉察到的	aware
严重的	bad	fatal	grave	nasty	profound	serious	acute
能力等）有限的	limited
指不胜屈	innumerable
侵犯的	aggressive
命令的	imperative
合法婚姻所生的	legitimate
干冷的	crisp
（声音	monotonous
公务的	official	state
通常的	customary	usual	accustomed
早熟的	forward
拙劣的	ordinary
附属的	subordinate	accessory	accidental	adjective
左侧的	left	port
不相似的	unlike
（数量）相当大的	tidy
立即的	summary	instant
专业性的	professional
（形状	uniform
心烦的	upset
与敌对力量相关的	enemy
争权夺利的	political
意识到的	aware	sensible
敏锐的	sharp	shrewd	acute	keen
志愿的	voluntary	volunteer
威风凛凛的	August
可变的	variable
较小的	less	minor
塑性的	plastic
粗陋的	spare
不正的	false
繁荣的	prosperous
概要的	capsule	first
爱国主义的	patriotic
应酬的	polite
没完没了的	eternal
富于战斗性的	militant
不加掩饰的	naked
向内的	inward
怪诞的	romantic	weird
讹	erroneous
短暂的	brief	short	temporary	transient
自制的	continent
失明的	blind
可行的	feasible
新近完成的	raw
匿名的	anonymous
辐射的	radiant
空虚的	blank	empty	vacant	void
有错误的	faulty
热带的	tropic	tropical
锐利的	keen
表示的	indicative
二者	both
顺序排列的	serial
播音的	broadcast
交织的	shot
应该的	proper
难以置信的	fabulous	incredible
尖刻暴躁的	brittle
一样的	even
[植]附着的	coherent
父系的	spear
缄默的	mute
参加的	participant
子代的	daughter
一点儿也没有	no
特级的	imperial
五十个的	fifty
成团的	lump
海军的	marine
受版权保护的	copyright
交替的	alternate
贸易的	commercial
矫揉造作的	precious
表面上的	technical	external
无理性的	absurd
绝对必要的	indispensable
粗制滥造的	coarse
谨慎的	conscientious	discreet	religious	cautious
出身于…的	born
成分的	component
太少的	miserable
安全的	safe	secure	security
娴	skilled
地方的	country	local	rural
放射性的	radioactive
不考虑的	irrespective
坚持的	stubborn
慢吞吞的	lazy
合法的	just	legal	legitimate
[物]临界的	critical
喀嗒一声扣下的	snap
依照惯例的	conventional
短时间做成的	quick
道德败坏的	corrupt
红色的	red
悭吝的	shabby
等效的	equivalent
（人、树木、鸟或动物）成熟的	mature
畏惧	afraid
有法律效力的	valid
谷物制成的	cereal
体力的	manual	mechanical
向前方的	forward
西部的	west
海产的	marine
纤细的	fine	slim
正方形的	square
不直截了当的	roundabout
古罗马的	Latin
造反的	rebel
因而发生的	resultant
还可以的	comparative
本质的	essential	interior	intrinsic
难以理解的	mysterious
右边的	spear
极高的	steep
成千的	thousand
所谓的	so-called
贫穷的	poor
有把握	definite
黄色的	yellow
照耀的	radiant
带有傲慢	arrogant
完整的	complete	full	whole	integral	integrate
情绪低落的	damp
缺乏深度的	superficial
符合逻辑的	logical
本…	this
片状的	sheet
往国外的	abroad
醉的	drunk
神乎其神	marvelous
全体的	blanket	entire	general	overall
罕有的	unusual
（重要性、规模、质量等）居第二位的	second
语言学的	linguistic
精巧的	cunning	elaborate	ingenious
宏大的	grand
因中毒引起的	toxic
更远的	farther	further
另外的	otherwise	second	additional
业余的	amateur
柔和的	soft
（数量）较多的	superior
小心的	careful	discreet	prudent	cautious
无色的	white
定时的	time
级限的	threshold
愉快的	fragrant	gay	happy	jolly	merry	nice	sweet
好动的	restless
试验的	tentative	trial
指挥的	command	directory
间歇的	intermittent
寓言般的	fabulous
无法无天的	gay
（男人或其举止）故意带女子气的	camp
被争论的	controversial
包括…的	inclusive
最幸福的	best
政府首脑的	summit
固体的	solid
间接的	roundabout	secondary
深赤褐色的	liver
攸关的	fatal
最大值的	maximum	peak
未必的	unlikely
意义深远的	profound
有利于健康的	benign
可塑的	plastic
东北部的	northeast
随便哪一个	any
被朗读的	read
下落不明的	missing
随机的	random
同等的	coordinate
超越国界的	international
音乐的	musical
缺乏保护	naked
使人愉快的	fun	glad
不断变化的	dynamic
命中注定的	fatal
死气沉沉的	still
分布广的	widespread
各式各样的	different
斜纹的	bias
集中的	mass
教堂的	cathedral
精致的	fine	sophisticated	exquisite
骄慢	arrogant
一日的	daily
给人深刻印象	effective
必须使用的	regulation
多的	many
谐	humorous
定期发行的	periodical
新鲜的	crisp	fresh	new
太阳的	solar
棕黄色的	tan
保安的	security
腐烂的	corrupt	rotten
（对细节）不厌其烦的	thorough
保暖的	warm
好战的	militant	military
吵闹的	turbulent
晦涩的	obscure
红头发的	red
少量的	light	spare
防…的	proof
惟一剩下的	last
（亲属关系）近亲	near
陌生的	strange
自觉的	conscious
容光焕发的	radiant
西北部的	northwest
模仿的	simulate
高原（地区）的	highland
陈腐的	commonplace	fossil	stale
通晓的	familiar
艺术的	art	artistic	technical
光明	promising
相匹敌的	peer
有爱国心的	patriotic
疏远的	strange
新垦地的	frontier
明白道理的	reasonable
挑剔的	particular	select
（受）损坏的	hurt
精通文学的	literary
极恶的	enormous
祖国的	country
本质上的	inward
加的	plus
蔬菜的	vegetable
相继的	successive
相关联的	relevant
最令人不满的	worst
值得崇敬的	sacred
警惕的	awake	alert
（金属材料）制成薄板（或薄片）的	sheet
后者的	latter
（痛苦	conscious
[法]民事的	civil
绵	continuous
隐居的	solitary
初等	elementary
善感的	susceptible
地方自治的	municipal
动力的	dynamic
僵硬的	rigid	stiff	wooden
[商]人造的	technical
不尊敬的	regardless
偶尔的	occasional
初级的	elementary	preliminary
公道的	reasonable
愿意帮忙的	helpful
文艺）协会的	academic
术零值的	null
[美国英语]分期（付款）的	time
最愉快的	best
微弱的	faint	light	lunar	small	thin
亲自的	personal
橡胶制成的	rubber
传统的	classical	conventional
宝贵的	precious	valuable
危害极大的	terrible
没有活力的	still
花园的	garden
代理的	deputy	agent
失去的	missing
兆头好的	lucky
有构架的	frame
诡秘的	mysterious	sneak
全球性的	global
永恒的	constant	eternal	permanent
邪恶的	evil	foul	vicious	wicked	black
宿命的	weird
百分之…支付利息的	percent
紧凑的	compact	tight
荣誉的	glorious	honorable
代替的	vice	alternate
富饶的	rich
推想的	theoretical
普通教徒（有别于神职人员）的	lay
园艺的	garden
那样的	that
很	very
（质量等）低劣的	inferior
雌性的	female
高质量的	quality
接近末期的	later
单调的	bald	flat
机械学的	mechanical
艺术品的	art
注重实际的	practical
正转的	clockwise
冬播的	winter
资格老的	elder
脱脂的	skim
（味道）不浓的	mild
抵消的	offset
令人愉悦的	welcome
严重的(bad	worse
狡猾的	cunning	sharp	shrewd	slippery	sly	subtle	funny
大的	big	massive
高架的	overhead
消逝的	extinct
客座的	guest
外部的	outer	outside	exterior	external
昏乱的	dizzy
主要的	arch	chief	fundamental	key	king	leading	main	major	master	predominant	primary	principal
卵形的	oval
最大量的	maximum
两院的	joint
流畅	affluent
相当[类似]（另一种属）的	representative
梦的	dream
[语]宾格的	objective
有前途的	promising
（粒子）实际存在的	virtual
俚色情的	skin
〈美俚〉外表的	technical
带领	conduct
[桥牌]已成局的	vulnerable
美缺乏的	shy
口头的	oral	verbal
代议制的	representative
垂直的	erect	up	upright	vertical
适度的	moderate	modest
强健的	nervous
可应用的	applicable
合成的	complex	component	compound	resultant	synthetic
充沛	plentiful
偏离轨道的	eccentric
有重大意义的	significant
后部的	rear
口讨厌的	poisonous
属于家庭的	family
调皮的	arch
颜色强烈的	violent
冷淡的	brittle	cold	distant
北风	northern
（种类或数目）有限的	narrow
微薄的	slender
周年的	anniversary
本来的	proper
不固定的	fluid
[语]不发音的	silent
上流社会的	polite	quality	society
合成树脂做的	plastic
短期的	short
合理的	fair	just	legitimate	possible	rational	reasonable	sound
有作战经验的	veteran
某文化群体的	ethnic
拉丁的	Latin
群众的	mass
竖立的	up	vertical
看不清的	dim
有才华的	capable
兴旺的	prosperous
容忍的	tolerant
时髦的	fashionable	in
海事的	marine
有关系的	participant
很少	few
非强制的	optional
口渴的	dry	thirsty
鞣皮的	tan
三个的	three
稳健的	moderate	prudent	sane
平静的	calm	calm	peaceful
运动衫式的	sweater
精心制作的	elaborate
赤褐色的	bay
苛刻的	severe
一体的	one
新奇的	novel
（价值、比率等的）平均数的	average
[语]完成的	perfect
（直接）生效的	efficient
决不是的	no
规范的	orthodox
无用的	vain	waste	futile
毫无掩饰的	bald
花言巧语的	plausible
无言的	dumb	silent
运动衫的	sweater
值得推崇的	holy
愿意的	content	willing
情节离奇的	romantic
不含酒精的	soft
宇宙的	cosmic	universal
隔离的	apart	isolate
非常的	awful	deadly	extreme	such	terrific
具有创造性的	productive
值得尊敬的	holy
分解的	analytic
生产性的	productive
非正式美好的	brilliant
呆滞的	dull
地表层的	upper
有规则的	orderly	systematic
漂亮的	brave	cunning	elegant	feat	good	handsome	pretty	smart
放牧区的	range
适合于正式场合的	dress
两者都	both
孤儿的	orphan
据以取名	name
有过失的	faulty
立刻的	prompt	swift
贪吃的	greedy
怀疑的	suspicious
地理学]早期的	lower
合乎规范的	textbook
突增的	explosive
迅速生长的	mushroom
瓦解的	disrupt
稀薄的	rare	thin
规格一致的	uniform
很少的	few
无官职的	private
无预期结果的	negative
愤愤不平的	bitter	indignant
设计独特的	ingenious
学究的	academic
固有的	proper	resident	inherent	intrinsic
直线的	linear
在前头的	head
面积的	super
不受注意的	regardless
非此即彼的	either
[宗]肉体上的	outward
摄氏的	centigrade
生理的	physiological
准确的	exact	precision	accurate
细微的	small
稀奇的	curious
幸运的	fortunate	happy
仙女似的	fairy
等值的	worth
事实上的	real	virtual
将来的	future
上升的	up	upward
疼痛的	raw	sore
九十的	ninety
（指人）知名的	eminent
围绕的	shut
传奇（式）的	romantic
不重要的	trivial	petty
温和的	amiable	benign	gentle	moderate	smooth	soft	slow
严峻的	severe	stern
安排好的	set
我的(I的所有格形式)	my
远隔的	distant
使人痛苦的	cruel
西南的	southwest
苛择的	select
物]磁极的	polar
有野心的	ambitious
〈古〉污染的	contaminate
无情的	brutal	cold	cruel	ruthless
（打斗、比赛等）一对一的	single
一般大众的	vulgar
放荡的	gay
总结的	summary
外观的	surface
频繁的	continual	frequent
进步的	progressive
现存的	living
软的	soft
变态的	abnormal
蓝紫色的	violet
炫耀的	ambitious
美味的	delicious
有关节的	articulate
内面的	interior
凄凉的	desolate
土著的	native
有理性的	reasonable
自发的	spontaneous	voluntary	initiative
（智力、思想、行为）成熟的	adult
引起麻烦的	troublesome
纯洁的	virgin	white
卖空者的	bear
违反的	contrary
放肆的	extravagant
（记忆、描述等）清晰的	vivid
马拉的	horse
无礼的	offensive
大都会的	metropolitan
清澈的	liquid	clear
在前部的	fore
稻草[麦秆]做的	straw
过分的	extravagant	steep	super	excessive
更好的	preferable
全体一致的	unanimous
光秃的	bald
白衣的	white
标准的	normal	standard
殖民地的	colonial
著名的	classic	famous	name	notable	prominent
[法]直辖的	ordinary
敏捷的	fleet	prompt	ready	smart	swift	active	keen
广播的	broadcast
鲜亮的	bright
焦急的	anxious
易弯曲的	flexible
地位最低的	least
愤怒的	angry	indignant
耐洗的	wash
在西北的	northwest
散装的	bulk
少数的	minor
恶毒的	malignant	vicious
不一定有把握的	unlikely
[物]超声的	supersonic
冷酷无情的	marble
不漏的	tight
十一的	eleven
未来的	prospective	future
[生]显性的	dominant
英俊的	clever
巧克力色的	chocolate
高音的	first
产金的	golden
牙科的	dental
定期的	periodical	terminal	time
有…的价值	worth
例行公事的	ritual
极薄的	sheer
[化]元素的	elementary
新颖的	original
素菜的	vegetarian
用于音乐的	musical
古董的	antique
正当的	proper	valid
名字的	nominal
惬意的	cosy	agreeable
紧要关头的	clutch
天鹅绒的	velvet
数据的	digital
银的	lunar
潜伏的	latent
赤裸裸的	bald	naked
不情愿的	reluctant
痛苦的	hurt	painful
徒步的	pedestrian
被动的	passive
〈俚〉同性恋的	queer
外交人员的	diplomatic
光线）来自北方的	north
坚固的	firm	sturdy
仅仅	mere
（辅音）齿音的	dental
符合要求的	satisfactory
九的	nine
严酷的	cruel
悲观的	gloomy	pessimistic
与同性恋者有关的	pink
供传阅的	circular
主修的（课程）	major
复杂的	complex	complicate	elaborate	multiple	sophisticated
（表示厌烦）可恶的	damn
易传染的	infectious
恐慌的	panic
新入会的	initiate
虚伪的	false	hollow
有女性气质的	feminine
懦弱的	wet
麻木的	asleep	numb
本地的	home	local
迂回的	circular	roundabout
活着的	live	alive
金（黄）色的	golden
声音低沉的	shut
医疗的	medical
推理正确的	logical
充满噪音的	noisy
柔软的	plastic	smooth	soft	velvet
歇斯底里般的	hysterical
比较而言的	relative
（服装等）相称的	decent
冗长乏味的	tedious
内含的	implicit
间歇性	intermittent
获奖的	prize
（级别、地位等）较高的	senior
[物]能产生裂变物质的	fertile
看得见的	visible	visual
无价值的	barren	pathetic	slim	sorry	straw	tin	trivial
次要的	fringe	second	side	subordinate
不清楚的	obscure
彰	evident
财源的	financial
令人不快的	offensive
〈口〉爱挑三拣四的	select
发生着的	on
记录的	documentary
孤独的	desolate	lonely
感受性强的	recipient
底部的	bottom
水平的	flush	horizontal	level
可以允许的	possible
温柔的	mild	still	sweet	tender
（豆科植物等）如灌木般长得低矮的	bush
极度渴望的	desperate
承担责任	responsible
拥有最高统治权的	sovereign
顶上的	top
年轻人的	young
爬虫类的	reptile
阈值的	threshold
道德的	moral
较低的	lower	under	underneath
忠实的	constant	faithful	true
〈俚〉难得	lucky
（智力	limited
塑造的	plastic
没有特色的	anonymous
受欢迎的	welcome
动人的	eloquent
[植]雄性的	male
可以忽略的	negligible
本征	intrinsic
细木工制作的	cabinet
民主主义的	democratic
金钱上的	pocket
丝的	silk
数值的	numerical
胜任的	equal	adequate
天然产生的	spontaneous
简明的	brief	concise
文明的	christian	civil
有感觉的	feeling
节欲的	continent
主张保护环境的	green
深奥	deep
短的	short
对政治有兴趣的	political
辛辣的	spicy
行政工作的	staff
清洁的	clean
预期的	prospective
无虚价的	net
深厚的	deep	profound
不带电的	neutral
接受的	agreeable
眼睛的	optical
老实的	honest
漠不关心的	indifferent
用化学方法制造的	chemical
惊慌失措的	panic
大主教教区的	metropolitan
小气的	cheap	petty
营利的	commercial
微湿的	damp	moist
支配的	dominant
（英德）万亿的	billion
高深的	advanced
动机的	motive
一千的	thousand
粗陶制的	stone
周刊的	weekly
大众化的	popular
可实现的	practical
认真负责的	conscientious
称心的	gorgeous	sympathetic
鲁莽的	foolish	reckless	rash
可洗的	wash
走得快	fast
朴素的	sober
斗志昂扬的	militant
声音的	audio	vocal
本着良心的	conscientious
偏袒的	partial
蜡制的	wax
逆向的	inverse
手提的	portable
克制的	continent
同高度的	level
资本的	capital	principal
正的	plus
富有成效的	productive
知名的	public
令人遗憾的	sad
老百姓的	vulgar
闪色的	shot
奇特的（指态度	bizarre
模拟的	mock
不可能的	impossible
急忙的	hasty
作为对某事的保证的	token
感情强烈的	violent
超级的	super
青春期的	adolescent
试验性的	pilot	experimental
轻微的	mere	mild
菱形的	diamond
〔口语〕愤怒的	mad
可以	okay
包罗万象的	catholic
风采优雅的	clever
焦躁不安的	restless
恮	cautious
中等的	medium	moderate	secondary	indifferent
所有可能的	every
特殊的	peculiar	rare	special
由相同（或同类型）事物（或人）组成的	homogeneous
受伤的	game	hurt
数字的	digital	numerical
货币的	monetary
落后的	backward	primitive
极力主张的	urgent
全力的	main
壮观的	spectacular	splendid
暂时的	jury	temporary	interim
杰出的	banner	eminent	great	outstanding	prominent	star	superb	excellent	exceptional
较后的	latter
真诚的	genuine	real	sincere
无声的	dumb	mute	silent
平庸的	commonplace	ordinary
紧急的	emergency
轻便的	portable
灵活的	elastic	flexible	quick
相应特点的	correlate
精确的	exact	mathematical	narrow	precise	precision	strict	accurate
颜色浓[深]的	saturate
烧红的	red
未加工的	crude	raw
有抵抗力的	resistant
滔滔不绝的	affluent
护理的	attendant
四分之一	quarterly
（演讲者、演奏者等）特邀的	guest
外行的	lay	amateur
异常的	eccentric	novel	peculiar	remarkable	abnormal
有根据的	historical	authentic
做不到的	impossible
别扭的	sour
公职的	official
有责任的	liable
（太阳等）上升的	orient
摩西的	mosaic
无大差别的	blanket
能抵御	proof
（两同姓男孩中）年幼的	minor
可比较的	comparable
原子核的	nuclear
亲切的	gracious	nice	sweet
慎	careful
更熟练的	better
疯狂的	crazy	mad
无遮蔽的	bleak
易爆炸的	explosive
[植]纵长的	vertical
仅有的	only	unique
严守标准的	precision
有运动力的	locomotive
体谅的	considerate
欠着的	owing
国民的	national
发音清晰的	articulate
不足轻重	negligible
草率的	hasty
忠心的	loyal
防水的	waterproof
摄氏温度计的	centigrade
害羞的	shy
有精神的	live
现在的	current	now	present	actual
可疑的	dubious	queer	shady	suspect	suspicious	funny
有才干的	able
室内的	indoor	interior
不实际的	romantic
有黏着力的	cohesive
已确定的	certain
没过的	flush
独创的	original
[动]不迁徙的（鸟兽等）	resident
（法美）十亿的	billion
钉的	pin
电学的	electrical
详细的	particular
桶状的	barrel
明断的	judicial
（指线条、小径等）锯齿形的	zigzag
[法]根据法律的	technical
书桌的	desk
（头、手等）朝上举的	erect
东南的	southeast
严谨的	strict
内陆的	inland
戏剧的	dramatic
好争论的	controversial
信末署名前用语	yours
极广阔的	cosmic
头的	head
已死的	asleep
过时的	ancient	antique
怯懦的	coward
神经的	nervous
（智力等）完全丧失的	bankrupt
未醉的	sober
过剩的	surplus
偶然（发生）的	accidental
热的	hot	thermal
有重大意义[作用]的	relevant
永生的	eternal
有理解力的	comprehensive
明智的	sane	sensible	sound	advisable
差强人意的	adequate
群居的	social
未开化的	savage
一整夜的	overnight
用录像磁带[录像带]的	video
外用的	external
钟爱的	partial
指整体中的）每一个	every
常见的	frequent	usual
同类的	fellow	homogeneous	kin	similar
酸味的	acid
干的干燥的	dry
（指工具、机器等）多用途的	versatile
有木架的	frame
丰饶的	plentiful
适合全家人的	family
亲爱的	beloved	dear
辉煌的	bright	glorious
空闲的	empty	leisure	off	vacant
平顺的	even
完全可能的	every
唇的	lip
爱好文学的	literary
柏拉图学派的	academic
不切实际的	dream	fantastic
困倦的	tired
空白的	blank
客套的	polite
具体的	concrete	specific
统计学的	statistical
广泛散布的	broadcast
水晶般的	crystal
（时间或地点上）在先的	preceding
宽敞的	ample	spacious
（文章、照片等）跨两栏（或多栏）的	spread
书桌上用的	desk
普遍存在的	prevalent
癔病性	hysterical
图案诗歌的	concrete
蓬乱的	shock
百万的	million
带有玫瑰香味的	rose
（在质量等方面）较好的	superior
以奇想主题布置的	theme
过激的	extreme
最差的	worst
天真无邪的	innocent
随意的	arbitrary	optional
办公时（或半正式场合）穿戴的	dress
有眼光的	shrewd
荒年的	hungry
确切的	relevant	distinct
相等的	equal	equivalent
〈口〉精神病的	mental
不狂暴的	still
动态的	dynamic
[语法学]将来时的	future
故乡的	country
人工的	artificial
跛的	lame
基督教徒的	christian
光彩夺目的	gorgeous
坦白的	frank
节约的	economical	saving
不透水的	waterproof
下级的	lower	subordinate	inferior
压倒一切的	overwhelming
愤慨的	indignant
遗憾的	sorry
[数学、统计学]相容的	consistent
方便的	convenient	handy
属于或关于嘴的	oral
露天的	outdoor
语单数的	singular
液体的	fluid	liquid
视觉的	optical	visual
市的	municipal
军事的	military
（昆虫的翅）纵折的	complicate
难理解的	intricate
末端的	extreme	terminal
存货的	stock
影子内阁的	shadow
结实的	massive	solid
不相干的人所做的（或提供的）	independent
显赫的	eminent
耐久的	durable	permanent
荒诞的	absurd
内幕的	inside
[口语]（体力或情绪上）疲劳不堪的	beat
荦	prominent
不连贯的	abrupt
国务的	state
用功的	diligent
[植]菊科的	composite
同性恋的	gay
貌似的	apparent
同时发生的	simultaneous
期刊的	periodical
发炎的	raw
爵士音乐的	jazz
比所示数量多的	plus
有选举权的	constituent
直觉的	gut
深一层的	further
有智慧的	wise
旁注的	marginal
多才多艺的	versatile
严守时刻的	punctual
灭绝的	extinct
全然的	sheer
为晚上的	evening
混	foolish
生理学的	physiological
闪电般的	lightning
符合公认的准则的	correct
骄傲的	popular
未经加工的	rough
有学问的	learned	read	scientific
怀有敌意的	hostile
下雨的	wet
散开的	diffuse
其余的	other
厉害的	keen
老的	old
听觉的	audio	aural
[化]可溶的	soluble
（植物、动物或机器）能在困难条件下生存（或操作）的	tolerant
本能的	gut
主人的	master
耀眼的	vivid
紧的	fast	tight
关于野味的	game
唐突的	offensive	abrupt
常务的	permanent
零星的	scrap
给人印象深刻的	impressive
运气好的	lucky	prosperous
皮革制的	leather
先锋派的	underground
不顾危险的	reckless
快乐的	gay	happy	sweet
似蜡的	wax
生气勃勃的	vital
农村的	rural
象征性的	token
处于…地位（境遇	situated
手写的	manuscript
顺风的	following
外来的	foreign	exotic
按顺序的	tactic
可畏的	formidable
壮健的	muscular
用于探测的	detective
不太可能的	unlikely
速记法的	shorthand
飘逸	graceful
侧面的	lateral	side
殷勤的	courtesy
联绵	continuous
专用的	special	exclusive
凉爽的	cool
统治的	dominant
破旧的	shabby
带有同等性质的	coordinate
惭愧的	ashamed
闻达	eminent
意味深长的	meaning
半生熟的	medium
显露	patent
[军]值班的	orderly
醇美可口的	ripe
物红外线的	infrared
爱打架的	aggressive
撕碎的	rent
差劲的	lame
刺骨的	bleak
过长的	long
某一	certain
十三的	thirteen
偶然认识的	pickup
有英雄气概的	heroic
计划中的	on
次等的	second
钦佩的	wonder
月球的	lunar
讨人喜欢的	favorable
抽象派的	abstract
热心的	eager	earnest	enthusiastic	keen
烤好的	roast
高超	excellent
无须重视的	slight
失去感觉的	numb
有手腕的	diplomatic
时髦人物使用的	fashionable
精神饱满的	energetic
（位置在）下面的	inferior
普通的	any	common	commonplace	everyday	garden	household	medium	ordinary	popular	routine	usual
秃头的	bald
（颜色等）刺目的	angry
深色的	dark
正点的	punctual
镇定的	calm	steady
活（着）的	living
休戚相关的	solidary
主笔的	editorial
军事]野战的	field
根据实验的	experimental
直言的	explicit
夫妻（间）的	marital
[语]陈述的	indicative
当代风格的	modern
世故的	prudent
先前的	previous
忙碌的	busy
必然发生的	automatic	inevitable
[哲]实在论（者）的	realistic
官方的	official
（式样等）不时新的	conservative
可口的	delicious
有关赛跑（或赛马	post
青铜制的	bronze
立体声的	stereo
可以察觉的	noticeable
帝国的	imperial
<口>非常愉快的	glorious
装订的	bound
部分的	part	partial
离心的	eccentric
性质上的	qualitative
血腥的	bloody
[法]占有的	manual
引人注目的	attractive	catch	dramatic	noticeable	remarkable	striking	impressive
肯定的	positive	safe
（文体等）紧凑的	compact
代表性的	typical
表面下的	underlying
纯朴的	native
精密的	exact
皇帝的	imperial
这个	this
农业的	rural
赞同的	favorable	sympathetic
富产的	plentiful
作玩具的	toy
奢华的	luxury
猛烈的	drastic	fierce	mad
占线	busy
最重要的	capital	cardinal	chief	foremost	lead	main	principal	staple	supreme
舞蹈的	dance
没人住的	void
手工操作的	mechanical
有条不紊的	systematic
显目	conspicuous
模糊的	dark	faint	loose	vague
有权势的	influential
（与另一个）完全相同的	duplicate
依次排列的	tactic
妩媚动人的	striking
优先的	prior
保留的	reserve
约莫的	approximate
缺德的	wicked
内政的	municipal
肥沃的	fertile	fruitful	generous	rich
交融的	mobile
（统称）饥民	hungry
急切	eager
好心的	kind
同谋的	accessory
可以并存的	compatible
天生的	born	native	natural	natural
能感觉到的	sensible
供工业用的	industrial
不激动的	quiet
（海洋	calm
分别开的	separate
手工的	manual
（技术）熟练的	expert
不灵活的	awkward
松的	loose
词语的	verbal
法定的	legal	official
无意识的	automatic	spontaneous
坚决的	firm	resolute
军用的	military
内省的	subjective
（含有）巧克力的	chocolate
巨大的	enormous	giant	gigantic	huge	monster	overwhelming	tremendous	vast
不听话的	naughty
悲观主义的	pessimistic
开端的	offset	preliminary
丑陋的	ugly
丝制的	silk
器官的	organic
西南部的	southwest
周年纪念的	anniversary
长度的	linear
不存在的	nowhere
性急的	rash
可用的	available	feasible	practical
作为代表或范例的	sample
没头脑的	silly
完成的	complete
有…倾向的	apt	liable	prone
升高的	upward
背阴的	shady
过的	per
稀释的	dilute
每周的	weekly
位于…的	situated
相反的	contrary	counter	cross	wrong	adverse	inverse
喜欢的	fond
撇去浮沫的	skim
可以接受或允许的	susceptible
有传染性的	infectious
海的	marine
在起作用的	about
处理（或置放）废品的	disposal
假的	fake	straw
显要的	important
孤立的	isolate
随和的	sociable
青年的	young
下台的	out
麻烦的	complicated	complicate
（因省钱、省时或省力等而）收效大的	efficient
美学的	aesthetic
紧密结合的	cohesive
终有一死的	mortal
离奇的	crazy	extraordinary	bizarre
沉着的	confident	steady
慎重的	deliberate	discreet	prudent
辩证的	material
婴儿的	infant
辛勤挣得的	honest
悦耳的	musical	musical
傻的	fool
可爱的	cunning	darling	fairy	lovely	pleasant	precious
纯种的	genuine
（向或来自）外国的	overseas
不在意的	absent
传染的	infectious
过火的	ham
不在的	away
本国的	native
状态	on
边的	marginal
好笑的	comic	funny
吓人的	fearful
预兆的	aural
统计的	statistical
俯卧的	prone
每个工作日的	daily
已故的	late
宜人的	grateful
含银的	lunar
熟悉的	familiar	well-known
有创造力的	creative	plastic
树篱旁的	hedge
同时存在的	simultaneous
略低于某标准的	minus
定期废止的	sunset
美民主党的	democratic
贵族的	noble	peer
完全缺乏的	bankrupt
经济的	economic	economical
够资格的	sufficient
合乎常理的	logical
义务的	compulsory
晚年的	later
紧邻的	next
南风的	south
令人同情的	pathetic
学院的	academic
充满变数的	dynamic
[保险业]总体担保的	comprehensive
（最）重要的	grand
少女的	maiden
商人的	merchant
不共戴天的	mortal
仪器的	instrumental
鼎鼎大名	well-known
含蓄的	underlying
更厉害的	worse
最后一棒的	anchor
我同	two
猥亵的	broad
非正很糟的	terrible
其他的	else	other
矮小的	dwarf	low
昏暗的	bleak	dim	obscure
狂热的	enthusiastic	fierce	wild
螺旋形的	spiral
险峻的	rapid	steep
好交际的	sociable
后进的	junior
石头似的	stone
最基本的	staple
不好的	bad	wrong
话语）单调的	monotonous
季度的	quarterly
浅的	shallow
例外的	unusual	exceptional
商业区的	downtown
精华的	essential
各种各样的	various
（君主权力）受宪法限制的	limited
荒诞主义的	absurd
完整无缺的	intact
救助的	saving
现场的	spot
私有的	private
聪明的	apt	bright	clever	pretty	quick	sharp	smart	wise	ingenious	intelligent
易碎的	brittle	crisp	porcelain	fragile
抗…的	proof
光秃秃的	bare
作为正式工作人员的	staff
[医]他觉的	objective
视频的	video
需要技能的	skilled
了不起	terrific
艰险的	nasty
公众的	popular	public
由受话人付费的（美国英语）	collect
（关于）过去某一特定历史时期的	period
精心守护的	jealous
相当多的	some
锐的	acute
[化学]当量的	equivalent
一定尺寸的	size
结果必然产生的	resultant
放在口袋里的	pocket
（在）海外的	overseas
矮的	short
狭窄的	narrow
无信息的	blank
昂贵的	costly	dear	fancy	expensive
喜剧的	comic
（费用等）经常的	overhead
心理的	mental
独立的	solitary
罪恶的	evil
非实用的	academic
性情温良的	clever
一半的	half
辣	ruthless
百分之…的	percent
打草稿用的	scratch
明明白白的	apparent
坏脾气的	cross	sour
桃红色的	peach
由嗓音发出或产生的	vocal
瘸的	game	lame
磁性的	magnetic
远的(far的比较级)	farther
（名誉）扫地的	bankrupt
匀整的	neat
不假思索的	automatic
贪污的	corrupt
工会的	labor	union
变质的	degenerate
较年小的	junior
充其量的	capacity
显示人类特有弱点的	human
渴望（求）…的	thirsty
玫瑰色的	rose
兼容的	compatible
空的	blank	empty	hollow	void
一打的	dozen
思想的	mental
任何…也	whatever
该注意的	considerable
用钻石装饰的	diamond
相对的	opposite	relative
处女的	maiden	virgin
决断的	decisive
赤裸的	bare
有利可图的	profitable
名声不好的	hedge	shady
表现出崇高的	noble
稳定可靠的	together
倍受喜爱的	darling
花钱多的	expensive
[语]边音的	lateral
前部的	front
豪华的	grand	luxury	splendid	superb	expensive
挑选出来的	select
楼上的	upstairs
边地的	frontier
唯一的	only	unique	solitary
不停运动的	restless
（两者）都不的	neither
明白的	evident	manifest	wise	clear
富于想象的	pregnant
同意的	agreeable
木材）切成特定尺寸的	dimension
组成的	component	constituent
金色的	gold
伴随的	attendant
财政（上）的	monetary
坡陡的	prone
感人的	impressive
财务的	financial
突然的	overnight	sudden	unexpected	abrupt
顶点的	vertical
纯粹的	mere
东方人的	oriental
能劝告的	advisable
不做作的	natural
令人怜悯的	poor
（两者中）任一的	either
深红色的	cardinal
最终的	final
重沓	redundant
认知的	cognitive
紧密的	close
国有的	national
特殊场合的	occasional
厌恶的	reluctant
利己的	selfish
三年级的	junior
无理的	abrupt
盐渍的	salt
有天才的	ingenious
机动车的	motor
[数]负的	negative
利用太阳能的	solar
军舰的	naval
习惯于	used
得罪人的	clumsy
刺激性的	incentive
高音调的	high
有钱的	rich
映成的	onto
视力的	optical	visual
专业的	professional
十三个的	thirteen
有诀窍的	trick
讥讽的	sarcastic
许多	many
追加的	additional
殖民地化的	colonial
不抵抗的	passive
辐射状的	radiate
必修的	compulsory
集体的	collective
近底部的	lower
究竟哪个	whichever
中毒的	toxic
任何	any
实心的	solid
银色的	silver
身体的	personal	physical
繁茂的	rank
称职的	competent
世仇的	feudal
普遍赞同的	orthodox
分裂的	rent	split	disrupt
肉体的	animal	material
温和	kind
初次的	maiden
（色彩等）花哨恶俗的	jazz
肌肉绷紧的	tense
有利的	beneficial	favorable
驯服的	tame
天赐的	divine
顽强的	iron
（蜜一样）甘美的	honey
（人或其举止）优美的	elegant
集群的	colonial
松软的	limp
（程度）很大的	supreme
紫外的	ultraviolet
和谐的	compatible
超音速的	supersonic
不断前进的	progressive
可耻的	criminal
无经验的	fresh	raw
气味的	aural
亲切友好的	cosy	lovely
昏迷不醒的	stupid
形形色色的	diverse
深刻的	deep
同样的	same	similar	alike
衣衫褴褛的	shabby
地位较高的	upper
不易相处的	difficult
空想的	fantastic	romantic	aerial
直的	direct	straight
按照（或依据）书本的	book
拉丁语的	Latin
甜言蜜语的	candy
大胆的	confident
有希望的	likely	promising	prospective
等价的	equivalent
近代的	modern	recent
年纪较大的	elder
曲折	intricate
脱离常轨的	deviate
恶性的	malignant
极限的	extreme	ultimate
不信任的	suspicious
叙述的	narrative
（时间上）稍前的	previous
在位的	in
驾驶员的	pilot
必须的	integral
剩下的（钱等）	spare
〈美俚〉（服饰）花哨的	candy
最多的	most
需用智力的	intellectual
僻静的	quiet
顾虑周到的	prudent
在附近的	nearby	about
（协议）无法律效力	null
更好的(good和well的比较级)	better
多情的	fond	romantic
蛋白质的	protein
占先的	prior
繁华的	busy
肥的	fat
得意的	proud
不可更改的	final
比得上的	comparable
科学的	scientific
有关的	relevant
难以相处的	brittle
热湿的	sticky
不相干的	foreign
爆炸的	explosive
不可思议的	magic	marvelous	mysterious	weird	incredible
心神不安的	uneasy
单个的	solitary
部落的	ethnic
对面的	opposite
粗暴的	tough
副本的	duplicate
体贴的	considerate	kind	thoughtful
（表达或感知）含糊的	vague
细致的	nice	precision
[生]变异的	variable
未搀水的	neat
有病的	funny	invalid
尽责的	responsible
丰富的	ample	fertile	flush	full	plentiful	rich	abundant
正面的	front
（衣服等）定做的	custom
公民的	civil
乐意的	glad	willing
大批的	bulk
内心的	mental	private	inner	interior	internal
现成的	forthcoming	ready
（对王族及其行为的敬语）仁慈的	gracious
幽静的	lonely
蹩脚的	ham	lame	tin
many的最高级	most
辽阔的	broad
无人的	desert	desolate
锡制的	tin
（知识）广博的	spacious
粗杂的	crude
空洞的	empty	hollow
那些的	those
熟练的	delicate	pat	skilled	skillful
进攻（性）的	offensive
最后的	final	last	net	ultimate
[语]综合的	synthetic
狠	ruthless
稀疏的	thin
免税的	free
即将到来的	forthcoming	this
矿物的	mineral
年年的	anniversary
头顶上的	overhead
树篱下的	hedge
活动着的情况	on
谷物的	cereal
下等的	lower	inferior
明白易懂的	intelligible
稳定的	permanent	stable	steady
可食用的	edible
事实如此的	so
大多数的	most
肯定	definite
文学的	academic
公正的	judicial	just
东部（地方）的	eastern
度量的	metric
敏感的	sensitive	subtle	acute	alive
隆重的	solemn
原始的	fundamental	original	primary	primitive	virgin
最严重的	worst
可信赖的	reliable	solid
较少的(little的比较级)	less
陡峭的	bold	sheer	steep	abrupt
非正统的	alternative
（故事等）猥亵的	spicy
北方的	north	northern
平日的	usual
助理的	assistant
满出的	overflow
慈悲的	tender
更坏的	worse
压倒一切的欢乐	overwhelming
侦探的	detective
具有某个时代特征的	period
[法]优先的	underlying
华美的	rich
新古典风格的	empire
英勇的	heroic
客观的	objective
孤傲冷漠的	cool
毫无结果的	nowhere
过量的	excess
正规的	legitimate	normal	precise
这	this
狡诈的	sly
自主的	independent
粗鲁的	bush	country	crude	robust	rough	rude
不可能发生的	unlikely
俚俗的	vulgar
沉思的	thoughtful
怯生生的	backward
干咳的	dry
侵略的	aggressive
死去的	dead
邻接的	neighbor
急剧	sudden
认真的	serious	intense
手边的	handy
正大光明	conscientious
纯的	net	pure
无感觉的	dead
显示…的特征的	characteristic
使精炼	polish
曲线形的	curve
[细胞]细胞核的	nuclear
有资格当选的	eligible
不公开的	closet
青春的	green
目标的	objective
特有的	characteristic	own	peculiar	proper	very
广袤的	broad
兢	cautious
异乎寻常的	unusual	exotic
谦和的	gracious
九个的	nine
极不愉快的	sticky
易受感染的	susceptible
永久的	eternal	perpetual
指导的	directory
起推动作用的	locomotive
永久（性）的	permanent
哪一些	which
难办的	tough
硬的	hard
广泛生长的	vegetable
（用于表示烦恼）讨厌的	wretched
相异的	unlike	alien
第一流的	banner	bully	champion	classical	first	foremost
愚蠢的	empty	fool	foolish	stupid	dizzy	ridiculous
语分析型的	analytic
十字形的	crucial
盘旋的	spiral
共同的	collective	cooperative	joint	joint	mutual	party
保密的	security
可察觉到的	visible
可敬的	honorable
平常的	average	conventional	everyday	ordinary	trivial	usual
摹拟的	synthetic
海底的	submarine
之前的	late
金本位的	gold
不确定的	tentative
零散的	odd
刚过去的	this
平地上的	surface
有把握的	secure	sure
习用的	conventional
一定的	definite	sure
大声的	loud
指状的	digital
奇特的	singular
无精打采的	tame
可取的	desirable	saving	advisable
不可缺少的	indispensable
毗邻的	adjacent
上面的	overhead	upper
成双的	twin
栎木制的	oak
下流的	blue	dirty	foul	nasty	naughty	shabby	spicy	vulgar
刚硬的	rigid
出自傲慢	arrogant
乳品的	dairy
联邦（制）的	federal
好斗者	militant
拉紧的	tense
仓促完成的	hasty
例行的	routine
处于轻松的	comfortable
寂静的	silent
有…的财产	worth
[语]（语音）紧的	tense
摹造的	false
不顺手的	awkward
试探性的	tentative
鼓励性质的	incentive
全局的	global
单调沉闷的	tedious
稻草的	straw
昭著	evident
共享的	joint
低劣的	bad	cheap	hedge	poor	shabby
悲剧的	tragic
欧美的	western
独特的	characteristic	proper	unique	unusual	exceptional	individual
无辜的	innocent
最近的	current	last	late	recent	up-to-date
重大的	deep	fatal	grave	great	important
五彩缤纷的	rainbow
肮脏的	dirty	nasty
暗藏的	closet
缺乏活力的	feeble
在历史上重要的	historic
连带的	joint
大约	some
以前的	back	fore	former	old	past	previous
直上的	vertical
（工作）困难的	painful
（因人员过剩）被解雇的	redundant
含铁的	iron	irony
每	each
（职位）空缺着的	void
映射的	onto
懒惰的	lazy
专制的	arbitrary
精力旺盛的	energetic
有磁性的	magnetic	polar
特派的	extraordinary
[法]认证了的	authentic
上级的	over
晚的	late
有进取心的	aggressive
详尽的	full	thorough
概括的	summary
中间的	middle	intermediate
精神上的	moral
有口才的	eloquent
无形的（指银行、旅游等服务）	invisible
相同的	like	parallel	same
深信的	confident
顽强的或有决心的	stubborn
开着的	open
序言的	preliminary
[常作B-]“反传统一代”成员的	beat
暗号的	signal
关于社会问题的	problem
不明确的	ambiguous
社会的	social
轻率的	blind	hasty	rash
急剧升降的	steep
同阶层的	horizontal
神智清楚的	rational
真挚的	earnest
贫瘠的	barren	lean
[计]全程的	global
激动人心的	dramatic
孝顺的	obedient
著称	famous
扎制成片的	sheet
成对的	duplicate	twin
友好的	friendly	nice
开心的	fun
每日一次的	daily
有（学士）学位的	graduate
东方文化的	oriental
硕大无朋	gigantic
喧闹的	noisy	furious
特有的或特别的	typical
集中起来的	concentrate
像男人的	masculine
大块的	massive
（英国）保守党的	conservative
必须做的	compulsory
[计]常驻的	resident
及时的	timely
奋发的	strenuous
陌生的(strange)的比较级	stranger
经济学的	economic
现行的	actual
婚姻的	marital	married
理想的	dream
堕落的	corrupt	degenerate	rotten
哑的	dumb	mute
徒劳的	empty	vain
包容一切的	catholic
严格的	firm	harsh	rigid	rigorous	strict
右方的	right
悟性好的	comprehensive
来自勤劳的	industrial
密集的	tight	dense
广泛的普遍的	catholic
不优美的	awkward
慢性的	chronic
主观的	arbitrary	subjective
特优种	predominant
线性的	linear
给与形态的	plastic
临时的	casual	extraordinary	false	occasional	temporary	transient	interim
奇异的	fantastic	unusual	weird	exotic	funny
难看的	ugly
恰当的	apt	fit	just	meet	suitable	well	adequate	appropriate
…的（事物或人）	what
被俘的	captive
过逾	excessive
闪亮的	splendid
可拆卸的	slip
有名无实的	paper
类似的	analogue	parallel	similar
遥远的	far	away	distant	farther
剩余的	odd	remainder	remnant	scrap
专家的	expert
由发动机推动的	motor
加强的	intensive
易损的	delicate
八十个的	eighty
适时的	timely
坚韧的	tough
刚好够的	bare
有财产的	substantial
人种的	racial
流通的	circular
影像的	video
信基督教的	christian
四处走动的	about
智[脑]力的	mental
凄惨的	terrific
感情	conscious
应有的	due
第二的	secondary
淡水的	fresh
顺从的	conform	obedient
南部的	lower	southern
同一行业的	horizontal
灰白的	grey
浓厚的	generous	dense
多余的	redundant	spare	spare	superfluous	surplus
基因的	genetic
精力充沛的	dynamic	energetic	robust	sturdy	vigorous
未成年的	minor	infant
始终如一的	constant	uniform
服从的	obedient
枯燥无味的	monotonous
无异议的	unanimous
太招摇的	loud
重的	heavy	massive
前列的	leading
倾斜度小的	gradual
拉丁姆的	Latin
向下的	down	downward
有才能的	capable
竞争的	competitive	rival
简炼的	elegant
成为一部份的	implicit
有限的	finite	finite	limited
出席的	attendant	present
动物的	animal
神志清醒的	conscious
根据太阳决定或测定的	solar
应考虑的	considerable
分别的	respective
驯养的	domestic
可得到的	visible
[生]第一代的	daughter
流行音乐的	pop
厚颜无耻的	confident
好争斗的	aggressive
纯净的	self
有引擎的	motor
不平常	different
充裕的	comfortable	plenty
无疑问的	implicit
贫乏的	poor
三倍的	triple
初次（听到）的	new
每…一次的	every
有意的	conscious	voluntary
词藻华美的	purple
敕许的	royal
不顾的	irrespective
考虑周到的	discreet	thorough
有魅力的	attractive	magnetic
未预见到的	sudden
实践的	practical
似乎不停的	eternal
八十的	eighty
有瘾的	dependent
[摄]（底片）明暗度强的	intense
暗淡的	bleak	dim	mat	neutral	pale
甜的	sweet
平淡无奇的	obvious	pedestrian
坦率的	genuine	open	straightforward	transparent
失效的	null
革命性的	revolutionary
[地质学	lower
理性的	rational
销的	pin
相当好的	decent	tidy
滑稽的	comic	humorous	funny
真正的	genuine	legitimate	proper	substantial	authentic	true
接替的	successive
取决于…的	dependent
每日的	daily
效果好的	fruitful
弹簧的	spring
不传导性的	opaque
（数量）大的	tall
溺爱的	fond	pet
未熟的	green
向东北的	northeast
古典的	classical
净的	net
深远的	deep
场面富丽的	spectacular
芳香的	fragrant	sweet
物质的	material	natural	outer	physical
作为毕生职业的	career
不寻常	extraordinary
直立的	erect	upright
使用着的	on
边界的	frontier
必要的	essential	necessary	imperative
狂怒的	furious
许许多多的	thousand	infinite
逼真的	eloquent	living	realistic
工资极限的	threshold
附随的	subsequent	incident
血染的	bloody
平民的	civilian	private
真实可信的	reliable
坚牢的	firm
满的	full
使对手不能因增加一分而成平局的	insurance
确信的	confident	sure
冲淡的	dilute
健全的	good	sound	sturdy	valid	wholesome	healthy
劳工的	labor
成熟的	grown-up	ripe	adult
通用的	universal
驯良的	obedient
公认为优秀的	standard
隐蔽的	blind	closet	obscure	shady	underground
尖刻的	acid
线形的	linear
坚定	constant
完美的	perfect
好求知的	curious
系统的	organic
假装的	sham	simulate
人的	human
球形的	global
反向的	backward	cross
免费的	free
前任的	former	past
微不足道的	minute	negligible	nominal	peanut
耗油的	thirsty
懂道理的	responsible
每年的	anniversary	annual	yearly
（计划）庞大的	big
碳的	carbon
利用真空的	vacuum
王的	king
一切在内的	overall
长时间的	long
缜密的	rigorous
平方的	square	super
你（们）的（东西）	yours
不掺假的	sincere
虚像的	virtual
（肠胃）不舒服的	upset
爱好平的	peaceful
空腹的	hollow
宗教的	holy	religious	sacred	spiritual
（车等）到站的	in
位于附近的	nearby
（法律等）严厉的	drastic
最低的	minimum
平时的	usual
彩虹状的	rainbow
非原产地的	artificial
着迷的	mad
无聊的	empty	tiresome
模拟计算机的	analogue
显然	patent
智力发达的	intellectual
公认的	orthodox
三分之一的	third
[乐]基音的	fundamental
最低限度的	marginal
全面的	global	thorough
勤奋的	diligent
均匀的	homogeneous
肤浅的	shallow	superficial	surface
敕定的	royal
十进位的	decimal
较大的	horse
在…之前	prior
透明的	crystal	transparent	white
醒着的	awake
十分重大的	fundamental
荒谬的	foolish	nonsense	rediculous	absurd	ridiculous
弧形的	round
现代的	contemporary	modern	new	pop	up-to-date
两者择一的	either	alternative
[体]巩固球队领先局面	insurance
不独立的	adjective
至关重要的	vital
乡村音乐的	country
客场比赛	away
几乎没有的	few
表示感谢的	welcome
最少的(little的最高级)	least
金融的	monetary
怀恨的	bitter
崇高的	high	spiritual
这些的	these
反对的	contrary	wrong
月的	lunar
（美貌）惊人的	fabulous
坚硬的	stiff
破坏性的	destructive
敞开的	open
超自然的	weird
姐妹般的	sister
一知半解的	superficial
含羊毛的	fur
宠爱的	favorite	fond	pet
出殡用的	funeral
（家具、服饰、建筑等）某一时代的	period
生动的	graphic	live	merry	vivid
阴郁的	gloomy
钱的（尤指一国的金融）	monetary
联合的	joint	associate
有能力的	competent	potential	able
离开肉体的	separate
栩栩如生的	realistic
易有的	incident
正派的	clean	decent	nice
定居的	resident	stationary
乱	arbitrary
不可避开的	indispensable
较次的	less
翻新的	renovate
极端的	deadly	drastic	extreme	rank
圆形的	circular	round
集团外的	outside
机灵的	bright	pretty
崎岖不平的	rough
绝种的	extinct
位于角落的	corner
其次的	following
均衡的	even
普及的	widespread
往下的	downward
怕羞的	shy
仅有雄蕊的	male
富有的	rich	wealthy	abundant
个人的	personal	subjective	individual	intimate
有朝气的	young
同类型的	sister
微小的	miniature	remote	slight	slim	tiny
星的	star
荒废的	desolate
最少的	minimum
经过稀化的	rare
（指品质、特性）明显的	eminent
随心所欲的	arbitrary
随之而产生的	attendant
噩梦似的	nightmare
有为	promising
在顶端的	head
可赚钱的	profitable
多次重复的	continual
（选择余地、可能性等）非常小	outside
胆小的	chicken	coward	nervous	timid
瞬间的	instantaneous
男性的	male
文雅的	gentle	polite
向东南的	southeast
变性的	degenerate
神志正常的	sane
痼	chronic
干旱的	dry	dry	thirsty
不停的	continual
暖和的	warm
热情的	enthusiastic	tropical	warm	intense	intense
顺时针方向的	clockwise
[物理学]稳定平衡的	stable
独断独行的	arbitrary
正统的	orthodox
晚上用的	evening
迫切的	instant
远超过预期的	wonder
势均力敌的	equal
恢复的	renovate
黄褐色的	tan
由绝望而引起的	desperate
逻辑（上）的	logical
黑的	black
[音乐]沉重的	grave
独自地	solo
（措施等）积极的	energetic
即可使用的	operational
综合成的	composite
老练的	elder	ripe	veteran
想入非非的	romantic
值得做的	worthwhile
创新的	creative	revolutionary
害怕（做）	shy
没感情的	numb
醒目的	bold
低等的	sorry
五个的	five
须服从…的	subject
葬礼的	funeral
正是	very
（女子体态）优美的	handsome
惊人的	electrical	spectacular	tremendous	incredible
女子气的	feminine
逆的	adverse
喜庆的	festival
（与单数名词连用	every
无畏的	bold
偏爱的	partial
令人高兴的	glad
未经触动的	intact
褊狭的	local
当代的	contemporary
薄弱的	spare
先天性	intrinsic
神秘的	mysterious	secret
合乎情理的	sensible
无益的	frustrate
渐进的	gradual
完全的	dead	full	sheer	total	utter	absolute	integrate
液态的	fluent
被推翻的	upset
慷慨大方的	lovely
有益的	beneficial	good	helpful	profitable	useful
有美感的	artistic
悲哀的	sad
有势力的	important
敌方的	enemy
通信的	corresponding
心细	careful
紧接在后的	next
几个的	several
那	that	those
多功能的	compound	multiple	versatile
闷热的	sticky
裸体的	naked
油腻的	fat
怀孕的	pregnant
球面的	global
外表上的	surface	exterior
账簿上的	book
魁伟的	massive
学会的	academic
结束的	past	terminate
不稳的	mobile
残酷的	cruel	harsh	iron
雅致的	graceful	gracious
不寻常的	rare	alternative	distinct
道义上的	moral
可怜的	pathetic	poor	wretched
重要的	big	earnest	fundamental	grave	leading	major	material	meat	noticeable	serious	significant	special	important
霸道的	arbitrary
[植物]一年生的	annual
外加	additional
粘着的	coherent
女性的	female
安静的	orderly	peaceful
体内的	internal
（证券交易）虚假的	wash
富于成果的	pregnant
范围广泛的	extensive
激动的	hot
零售的	retail
保险的	safe
礼拜的	church
随便的	casual	familiar
饥饿的	hungry
守旧的	fossil
明显的	bold	conspicuous	evident	frank	manifest	noticeable	obvious	visible	distinct
如愿以偿的	successful
最高的	peak	supreme	top
无意义的	nonsense
充实的	substantial
冬季的	winter
100万以上人口的	millionaire
可投掷的	missile
（指人）好竞争的	competitive
单一的	self	single
难闻的	foul
摆脱了责任或义务的	quit
温湿	humid
癔病的	hysterical
茫然的	blank	vacant	absent	abstract
细腻的	exquisite
规定的	ordinary	regulation
枝节的	side
近似	near
仁慈的	benign	feeling	kind
节俭的	prudent
感激的	grateful
炎热的	tropical
符合的	corresponding
预先准备好的	beforehand
