着手处理	tackle	approach
使合适	qualify
盘弄	paw
筑堤遏（水）	bay
以…为生	living
期望	desire	hope	expect
受痛苦	hurt	suffer
用环连接	link
（使）腐朽	rot
用刑拘折磨	rack
出现	appear	arise	emerge	figure	happen	occur	present
把…因素包括进去	factor
成扇形	fan
使烦乱	torment
（在某物的内部）形成一层	line
吐白沫	foam
俘获	capture	seize
（按时间、顺序等）接着	follow
（通过妥协）解决债务、主权等	compound
用扫帚扫	broom
洗牌作弊	stack
依法进行	prosecute
强要	tease
通便	relax
使…轻快	brisk
弄糟	blunder	butcher
彻底探讨	exhaust
腐蚀（人的思想或品德）	contaminate
秘密策划	hatch
赞同	approve	consent	agree
[法]使无效	avoid
使脱离常轨	deviate
包括或由…构成	contain
打手势要求[指示]	motion
疲劳	fatigue	tire
许可进入	admit
删剪	cut
连续击打（尤指发出大声）	hammer
不确定	doubt
悲哀	weep
剔去…的骨	bone
详细地检查	study
锤打	hammer
热情衰减	flag
慢跑	jog	jog
使赞成	sell
阵亡	fall
依靠机械力移动	purchase
把…装饰得有艺术价值	art
向…赠送	gift
租房	room
形成糖	sugar
轻挪	stroke
放出束状的光（或热）	beam
用力拉	strain	tug
使明显	evidence
变得轻快	brisk
力争	strive
歧视	discriminate
出卖	betray	sell
使消逝	dissolve
使（船）服役	commission
把…当作婴孩看待	baby
用纽扣扣紧	button
变小或减少	diminish
建立	build	erect	establish	found	institute
[法律]具结	recognize
接受劝告	advise
以呻吟声说出	moan
在拐角处转弯	elbow
希望	care	desire	hope	hope	will
分开	part	separate	share	split
织布	weave
靠动力行进	power
作民意调查	poll
下决定	resolve
尤指平静地吐露	breathe
把…装上船	ship
心怀	harbor
有权	qualify
使产生	entail	make
正式提出	tender
应允	comply
侵占	convert
前后摆动	hunt
使适用	season
正式批准	legitimate
怀有某种意图或目的	intend
存放	lodge	store
进军	march
（在数量和质量等方面）胜过	exceed
迷惑	fox	glamor
准许（做某事）	allow
shall的过去式	should
迅速增加	mushroom
证明…有理	justify
做木工活	carpenter
皱（眉）	knot
扣留	detain	hold	withhold
行贿	bribe
扔]	bang
宣判	condemn	doom	pronounce	sentence
分析	analyse	criticize
拍电报	wire	wire
使（固态物）溶解为液体	dissolve
祈求	petition	wish
把…弄成管状	tube
穿过	penetrate
气喘	heave	pant
回避（问题）	beg
巡视	scout
[地质]侵入其他地层	intrude
使跳动	pulse
相配	blend	corresponding
[法律]非法劫回	rescue
怀疑等）	shrug
出生	come
施恩惠	oblige
使劲拉	tug
丢开	desert
丢弃	discard	junk	abandon
（伤口）流血	weep
赋予头衔	title
给…添加肥料	enrich
不在	absent
为…做出榜样	example
处罚军事犯	crime
使反感	disgust
[保]评定（赔偿要求）	adjust
滑动	glide
搞乱	tumble
（文学、戏剧等）对读者	carry
以焦油或沥青覆盖或涂抹（某物）	tar
被绊倒	tumble
下沉	settle
吃得使	eat
犯错误	blunder
跳伞	parachute
[计算机]使（数据）位移	shift
泊车	park
惊吓	appal	scare	startle
用老虎钳夹紧	vice
变复杂	complicate
泄漏	tell
从事园艺	garden
把…装入信封	enclose
发亮	lamp	light
弄乱	tumble
为难	puzzle
相应	correspond
快速搜寻	rifle
漏过	skip
有	be	have
〈罕〉做…的丈夫	husband
触摸	feel	feel	grope	touch
为…钉蹄铁	shoe
挥动…示意	wave
猛地咬住	snap
做菜	cook
（用钉等）钉住	pin
把裙子缝出皱褶	full
发现(find的现在分词)	finding
配置	station
开沟	ditch
取…的样品	sample
移民	transplant
使缓慢前进	work	worm
侮辱	insult
护送	escort
标出尺寸	dimension
剥去	strip
形成带状	ribbon
看不起	scorn	despise
给…增添风趣	flavor
收回意见	recede
为…主持婚礼	marry
一致	correspond	cotton	square	accord
企图	design	offer
烧伤	burn
创作（乐曲、诗歌等）	compose
安排或处理	engineer
环绕（圆形或环形物的）边缘	rim
捍卫	champion
啪地关上	clap
鼓吹	drum	advocate
当…的祖母	grandmother
把（精神病患者）正式送入精神病院	section
使显老	age
转晴	fair
俚开心地狂笑	howl
使安定	compose
使颤动、战栗或振动	thrill
使（手）窝成杯状	cup
代替	cover	replace	substitute
戳穿	pierce
（使）折断	fracture
投递	deliver
（使）增值	appreciate
确定…的位置	locate
周而复始	cycle
使陷入绝境	bay
砍	chop	chop
啮合	tooth
与…联系	contact
退去	sink
遵循	obey	adhere
使…隶属	subject
（人群）散开	spread
〈口〉使（自己思想）有条理	organize
发送（报道给报社）	file
给…穿上鞋	shoe
[棒球]击球	club
[医]探查（伤处等）	explore
[航海]升起桅杆	sway
湮没	submerge
[力]切变	shear
使某物倾斜	cock
举止端正	behave
踩自行车的踏板	pedal
欺侮	oppress
给予补偿	render
把…存入仓库（或栈房）	store
使名声受玷污	dirty
使残废	disable	lame
（使大便等）通畅	relax
储备	reserve
收缩	gather	narrow
把…分层堆放	layer
（成群地）匆忙赶往	bundle
对…无礼地说话	cheek
指导	coach	direct	guide	supervise	instruct
使再循环	recycle
加大马力	soup
吞没	gulf
link-（使）燃烧	burn
作出	give	prepare
拿走	withdraw
栽培	cultivate
帮助或益处	boot
密封	seal
充当…的角色	play
成为…的重荷	weigh
变粗糙	chap
被忽视	escape
（使）坚实	compact
蔑视	defy	mock	rubbish	scorn	disregard
（眼）作调节	accommodate
（尤指通过增添成就、成功等）使圆满	crown
喷射	jet	spray
引起…的疼痛（或痛苦、苦恼等）	smart
否认	contradict	contradict
使圆满完成	crown
愿望	desire
制作…的剖面图	section
涂油墨	ink
[解剖学]连接	articulate
咳嗽	cough
保证（做某事、遵守协议或遵从安排等）	commit
用铅笔写	pencil
霸占	grab
使破产	bankrupt	ruin
（嗓音）颤抖	shake
（使）船停靠码头	dock
勘察	prospect
给…盖墙压顶	cope
反向移动	counter
临时调派	second
听见	hear	hear
继任	succeed	inherit
疑惑	doubt
连接	connect	connect	couple	join	piece	tie	interface
泄愤	spite
更改	alter
妨碍	forbid	hamper	handicap	hinder	obstruct	preclude	violate	disturb	interfere	interrupt
盯着看	peer	stare
使记起	remind
使奋起	stir
论述	deal	treat	discuss
战胜	defeat	lick	overcome	triumph
编译	compile
沿…的边缘走	skirt
（使）流动	run
搔痒	scratch
急促地动	bounce
（轻轻或漫不经心地）扔	toss
去世	depart	exit
提取	dip	extract	abstract	distill
按预算来计划（或安排）	budget
鸣谢	acknowledge
晒干	weather
把…带错路	mislead
呜咽	sob
测…的速度	clock
搞糟	queer
（尤指事故中）伤害	injure
抨击	attack	attack	tilt	tilt
装备	equip	outfit	provide
飞驰	hell
找回	recover
更新	renovate	update
（做事）不出力	coast
出口	export
用网缠住	web
把…关在门外	shut
用力打	belt
[计算机]使联系	interface
想出	devise	study
出发	depart	head	leave	start
变坏(fall的过去式)	fell
[地]使风化	weather
慢走	wander
称…的重量	weigh
储蓄	save
起义(rise的过去式)	rose
使认识	acquaint
签字	sign
守候	watch
作演讲	lecture
披（披巾）	scarf
嗅着气味追赶	scent
窥探	mouse
使…变成	commute
收费	charge	toll
大减价	slaughter
link-嗅	smell
挟进	shut
使有动机	motivate
不费力地取得成功	coast
同等	peer
行军	march
（使）扩张	augment
放映（电影）	screen
劳累	burden
使痛苦	bug	kill	plague	rack	torment	torture	distress
努力	struggle	study	try	aim
妨碍睡眠（休息等）	disturb
点（头）（以示同意、打招呼等）	incline
使变白	snow
把…划分（常与out连用）	lot
预定	mean
把…装入桶	tub
&走	walk
把（酒	spoil
复述	repeat
端上	serve
使整洁	tidy
使目瞪口呆	stun
使褪色	fade
报晓	crow
做蜜饯	preserve
选拔	select
嵌接	tongue
扣除	deduct	subtract
夸奖	magnify
使加倍	duplicate
造成	generate
不参加	absent
（在比赛或其他竞赛中）落后	trail
[法]让与	convey
结心	heart
播放	broadcast
制止	curb	restrain	withhold
发号施令	boss
使同等	level
尖声地说（或唱）	pipe
用棉束填	flock
训练马溜蹄	pace
说（笑话）	crack
演奏	blow	play
确定（某人）为种子选手	seed
使充电	charge
引起恼怒	irritate
费心	trouble
为…造型	style
用栅栏围住	barrier
撞坏	crash
挫败	defeat	frustrate
使闪亮	twinkle
巴结	crawl
非正式〉使（伤口）炎或疼痛	anger
用仪器装备	instrument
应该	might	want
用油煎	fry
胜利	conquer
突袭	rush	surprise
进攻	attack	charge
应得赔偿	deserve
记分	score
位于或存在于（某物）之下	underlie
纵容	baby	indulge	indulge
拉伤	strain
翻倒	tip	tip
小船等擦着水面疾驶	plane
使隔离	insulate	isolate
飞行	fly	wing
充溢	drip	overflow
（使通过界面或接口）接合	interface
变平和	smooth
逐渐变细	diminish
做出计划	propose
斜钉（钉子）	toe
相异	differ
革新	renovate
起皱纹	wrinkle
推论	deduce
用历史故事画装饰	story
和…打官司	sue
速写	sketch
使成为孤儿	orphan
抵制（货物等）	boycott
用锉锉	file
加插	insert
展出	exhibit
商谈	talk
急速前进	spur
（飞机）爬高	climb
飞速传递	gallop
建造	build	build	construct
商定	agree
在…上抹水泥	cement
处死	execute
使闪耀	flare
使翻筋斗	loop
容许	concede	permit	suffer	tolerate	allow
冒…的危险	risk	venture
形成球体	sphere
计划或谋划	contrive
迈步	step
（费力地）拔出	extract
（尤指工作劳累后）坐下	collapse
借住	camp
为了支持或抵制某项特定目标游说	lobby
作曲	write
焊合	seam
（使）循环	circulate
追逐猎物	hunt
讨人喜欢	please
惊叫	exclaim
不能肯定或怀疑	doubt
提出…作为理由	allege
迅速打击	swing
开船	sail
退化	degenerate
找错误	fault
过分关心	fuss
[音乐]（尤指专业）改编乐曲	arrange
采坚果	nut
专注于	address
用散文写	prose
凶杀	murder
（房屋、地产等的）置得（指非继承所得）	purchase
照耀	blaze
前进(advance的过去式和过去分词)	advanced
缝（被）	quilt
可被切割	cut
[数]由上位借	borrow
给…划界	bound
克制	contain	refrain	withhold
驾	ride
表示…的意思	signify
测量	measure	measure	scale
使无资格	disable
满足需要	cater	service
编造	cook	forge	script
打开	crack	unfold
使笑得前仰后合	kill
找回猎物	retrieve
使完满	complete
构图	compose
预示：预言某事	predict
穿衣	dress
把…归入某等级	class
满意、喜欢(of)	approve
变成蓝色	blue
收回	retire
使飞翔	fly
成片展开	sheet
潜水	dive
作（战等）	wage
售票	ticket
&缝	sew
协同	coordinate
“concern”的现在分词	concerning
把…放在中间	middle
抽出	spare
使出神	entrance
以笑感动[影响]	laugh
欠…债	owe	owing
尤指用手播（种）	broadcast
流放	transport	exile
驳回	dismiss
盘旋	circle	curl	hover	orbit
漫游	cruise	cruise	range	wander	wander
裂开	rip	seam	seam	spring	yawn
卷绕成圈	coil
使更新	renew
生裂缝	flaw
飘扬	stream
油炸	fry	fry
合股	partner	partner
下跪	kneel
要求竞赛（或竞争）	challenge
感谢	thank
提供意见	advise
使惊异不已	dazzle
用粉笔写（记下）	chalk
加煤	coal
整理	arrange	dig	digest	order	right	sort	tidy	trim	do
（风）吹	blow
下跌	slide
紧握：保持紧握	grip
阅读	read	read
以图表画出	plot
[航海]吹长哨	pipe
〈俚〉吸引注意力	grab
权衡	balance	deliberate	weigh
指定（时间、日期、名称等）	nominate
保持原状	preserve
用引诱物召回（猎鹰）	lure
智能等）受阻碍	dwarf
为…发提（货）单	bill
止住	arrest	suppress
逐步上升	escalate
（按暂停键）暂停放音	pause
重新得到	retrieve
捕鱼	fish	fish	fish
用绷带绑扎	bandage
尖声啼鸣	pipe
对…信以为真	believe
用珍珠装饰	pearl
加油	gas	gas
（即兴）演奏	noodle
用计算机计算	compute
[航]向后倾斜	retreat
弹射出	eject
坐公共马车旅行	stage
突破	break
[军事]中间集结	stage
潜近	stalk	stalk
放出	discharge	liberate
裁判高声吹哨	blast
做…的买卖	trade
用杠杆撬动	lever
用碑牌纪念	tablet
撞倒	overthrow
调味或加沙司于…	sauce
感到高兴	cheer
用绳子捆绑	cord
使…略呈波形	wave
树起	pitch
把…塞满	jam
不及格	fail	fail	fail	tube
牵制	contain
危害	harm
为…提供资金	fund
铺铁轨	rail
使疼痛	irritate
参加野餐	picnic
在…上置鞍垫	panel
组成俱乐部	club
开价	offer
公开	disclose	ventilate
安抚	smooth
用软管浇	hose
取笑	guy	kid	tease
睁开	open	opening
迁就	indulge
使受耻辱	disgrace
用浆划动	paddle
专门从事	specialize
爆发	burst	erupt	erupt	outbreak
撇（嘴）	curl
使笑死了	kill
使变换方向	wheel
使隔热	insulate
进行各项准备工作	prepare
涨落	fluctuate
复写	duplicate
给…装护套	jacket
旋转	revolve	turn	twist	wheel	whirl
巡查	patrol
开始移动	roll
适合在舞台上演出	stage
[体]玩滚木球	bowl
部分重叠	lap
减少	decrease	drop	ease	ebb	lower	reduce
产生于	arise
抓…	reach
（使）某物变得不清楚	cloud
偷盗	cop
为…作目录	schedule
减小	decrease
（不愉快的事）突然降临	overtake
颠簸着前进	bump
锯	rip
归纳	generalize	sum	induce
得到或接受某部分东西	participate
用嘴唇接触	lip
[化学]加热	digest
牵就	humor
使呈彩虹状	rainbow
把…装入瓶中	bottle
切望	weary
言归正传	return
（从活动或组织中）退出	withdraw
变稳定	harden
接受	embrace	embrace	accept	adopt
悲痛	sorrow
练习	practice	practice	exercise
使败落	sink
冲破	burst
发出冒泡的声音	bubble
加偏压于	bias
匆匆送走	bundle
庆祝	celebrate	celebrate	commemorate
使好卖	sell
显得阴沉（或恐惧、愤怒等）	cloud
抓	scrape	scratch
承保	secure
张贴	paste	post	stick
心不在焉地说	mouth
延缓发作	postpone
受伤致残	cripple
使提防	precaution
与…打赌	bet
使合身	fitting
达到高峰	peak
萃取	concrete
发觉	find	found	perceive	scent	smell
飞逝	fleet
倒退	back	reverse
资源过剩	overflow
颁布	emit	publish
充盈	brim
勾住	link
审阅	process
终属	remain
取回	resume	retrieve
开张营业	open
代偿	commute
降临	land
避暑	summer
还击	counter
作为精华产生	distill
形成	form	form	generate	mould	shape
使过度工作	sweat
在船上工作	ship
伴随而来	attach
怂恿	egg	tempt
结（果实）	bear
显示	demonstrate	evidence	manifest	prove	read	read	reading	reflect	display
（使）留长	grow
交朋友	cultivate
给…染色	dye	stain
使坚固	firm
使隆起	ridge
像专家那样研究（或检查）	expert
牺牲	sacrifice	sacrifice	sacrifice
突出	highlight	project	tongue	exceed
作剪式移动（尤指腿）	scissors
碰到	confront
打乱	upset	upset
撒沙于	sand
用烟熏制	smoke
领先	exceed
把（某人	consider
[棒球]当接球手	catch
使为难	bewilder
把…借给	lend
缓和	relax	temper	alleviate	dull
探问	nose
[体育运动]举重	snatch
变得安全	secure
乱闯	mill
以…做赌注	venture
计算…的总数	total
相互作用（或影响）	interface
散发传单	leaflet
赋与…以（权力	clothe
使处于…地位（位置）	situated
投保	insure
插上插头	plug
为…装托架	bracket
在沸水中煮	boil
（使）滴下	drip
使被安排好	establish
结巴	stumble
僵硬不动	lock
使惊飞	flight
杀人	murder
有…的味道	relish
让（用于祈祷语气）	suppose
作某种评价	deem
欢迎	greet	receive	receive	salute	welcome
（把…）装饰得古怪而有艺术趣味	art
装底	bottom
容许复制的	copy
指控	accuse
撞到了一辆卡车上	slam
把…放入箱中	bin
布满	people
以地雷[水雷]炸毁	mine
对…起作用	influence
遏制[阻止]（液体的流动等）	stem
把…封为（贵族）	create
拉平	average	level	level
改进	remedy	improve
眩晕	reel	spin	swim	whirl
擦去…的灰尘	dust
突然发生	erupt
[法]撤消	reverse
混乱或吵闹	roar
冲撞	bump
主持	chair	moderate	preside
（为某事）联合	unite
拉（木材等）	snake
用真空吸尘器清扫	vacuum
用毛巾擦干身体	towel
分帧	burst
辐射	radiate
[非正式用语]饥饿	starve
亲身参与	experience
[生]拟态	simulate
成功	score	succeed	win	achieve	prosper
占卜	divine
推动	force	propel	push	push	further	impulse
进行探求	quest
行刺	assassinate
核准	approve
受饿	starve
当观察员	observe
借助压条法	layer
批评	criticize	fault	knock
谋求	seek
驱散	dissipate	scatter
抢劫（海上船只）	pirate
额外免费提供（设备等）	bundle
游行	parade
使自花授精	self
使紧缺	pinch
使合作	partner
来做	come
认捐	subscribe
跟踪（进展或发展）	chart
不懈	strain
轻轻向上击	spoon
砍伐	log	lumber
朝…看	front
等同	amount
瞭望	overlook
给（负重的动物）套轭具	harness
陈情（试图努力影响某人采取有利行动）	lobby
使结晶为砂糖	candy
轻轻地捏	squeeze
使冷静	calm
侵害	trench
用马赛克装饰	mosaic
参加保龄球赛	bowl
使陶醉	charm	thrill
（衣服等）被烫平	iron
变窄	narrow
清除嗓子中的（痰）	hawk
拐过	round
使液化	dissolve
覆盖层脱落	peel
保养	maintain	service
热望	pant
作答	reply
起航	originate	sail
用桶装	bucket
相遇	meet
塞住	shut	stop
对…表示怜悯	pity
估量	estimate	measure
增进	contribute	gain	further	increase	increase
[法律]把（财产	assign
当木匠	carpenter
灌满	heap
钳制	vice
（英国）对儿童进行特殊教育评估认定	statement
闩（门等）	bar
贴现率	discount
使持续	continue
（使）疲乏	weary
为特殊目的而设计	intend
调动	mobilize
贴邮票于…	stamp
遮住	conceal	hide
用哨声使…行动	whistle
一个接一个地移动	stream
拆开	detach
开（枪或其他武器）	shot
吓走	frighten
突然跌倒或落下	dump
偶然被发现	chance
在于	consist
打算	calculate	meditate	plan	propose	propose	purpose	want
制造硬币	coin
向…勒索（或榨取）	squeeze
使…恼怒	bother
保持不变	hold	wear
使茫然	dizzy
答应	undertake
擦去	scrape	wipe
用标度盘测量	dial
[桥牌]逆叫	reverse
把…赶上树	tree
弄醒	wake	waken
使轮流	rotate	alternate
搞同性恋	camp
（规则等）适用于	blanket
将（钱）存入银行	bank
使纠结	knot
竞争	compete	contend	contest	contest	rival	tug	dispute
举行	stage	stage
恶化	degenerate	deteriorate	sour
节俭地使用	husband
租借	lease	rent	tenant
挥舞	swing	wave	flourish	flourish
使成为岛屿	isle
意见相左	differ
赞扬（或称颂）…为（尤用于报章等）	hail
（使）猛撞	crash	dash
包括	cover	embrace	comprise	include
盖免费邮寄公章	frank
检修	service
打趣	jolly
暴动	riot
打翻	upset
平均：作为或达到一个中间值	average
当销售员	clerk
成为…的边	margin
埋葬	bury	tomb
在…设置路障	road
交给…基本知识	ground
航行（…距离）	log
表演过火	ham
使弹回	bound
美口想要	admire
撒盐	salt
闻出	nose	smell
患热病	fever
属于	belong
使出声	sound
使某人免遭（麻烦等）	spare
使延伸	continue	spin
称呼	style
映出	reflect
使能够	enable
使极度痛苦	anguish
上下摆动	nod
给小费	fee	tip	tip
推荐	commend	propose	recommend	recommend
显而易见	show
用手枪射击	pistol
兴旺	blossom
当服务员	steward
敲响	striking
使悔悟	convince
苦学	bone
为…悲哀	pine
凌辱	insult	outrage
设岗	post
使（发育	dwarf
强奸	force	rape	violate	outrage
咬牙	grind
[计]鼠击	click
使湿透	saturate
使泄露	leak
（使）变模糊	blur	dim
成熟	flower	mature
实现	attain	realise	achieve	implement
[数学]作积分运算	integrate
猛冲直撞	crash
开花	bloom	flower
使符合	shape	accord
皱眉	frown
听起来	sound
（指光）闪烁	wink
使产生关系	interest
区分	difference	differentiate	parcel	separate	distinguish	distinguish
笑	laugh
细想	consider
专心致志	apply	bone
发脾气	crab
经遗传获得（品质、身体特征等）	inherit
准备好	brace
问（某人）有没有胆量（做某事）	dare
变形	distort
悲痛万分	anguish
垂首	bow
吮吸	suck	suck
仿佛	seem
作主持人	moderate
区别	compare	differentiate	discriminate
招致	draw	provoke	court	incur	invite
在…留下痕迹	mark
自由浮动	float
容纳	contain	hold	lodge	accommodate
给…提供衣服	clothe	clothes	clothing	dress
签署	subscribe
从（某角度）报道	angle
兼备	unite
高飞	soar
〈俚〉已理解	dig
把（土地）划分成块	lot
破产	fail	fail	ruin
紧绷	strain
围进	shut
抽杀	smash
烤	bake	bake	roast	whip
烧	flame
加灯罩	shade
使认错[罪]	convince
奖给	award
特化	specialize
辩护	defend	plead
动员起来	mobilize	mobilize
使复位	restore
冒烟	fume	smoke
结合在一起	integrate
使防水（或防火等）	proof
仓促完成	rush
委派代表	delegate
使热	heat
和…结婚	spouse
折断	break	crack	snap
彻底搜查	comb
跳踢踏舞	tap
安装	erect	fit	fitting	mount	install
（人的思想等）走神	wander
露出裂口	gap
给…加标题	headline
忧虑	concerning	fear
使成双	duplicate
烦扰	bother	hound	persecute	worry
出错	slip
消逝	elapse	glide
参加社交聚会	party
使成铃状	bell
吼叫	blast	howl	roar
定位	locate
尤指钱）	lose
分页	burst
逗留	continue	linger	pause	remain	stop	abide
沉溺	indulge
偷听到	overhear
争吵	differ	quarrel	dispute
麻烦	bother	trouble
使平滑如玻璃	glass
自动导航	home
十分害怕	dread
把…浇铸成铅版	stereotype
离群	wander
使劲搬动	muscle
轻触	brush	kiss
打败（敌人）	conquer
辩驳	contest
加（金属）衬套于	bush
弄平	level
击打	whale
弥补	compensate	repair
（使）放松	relax
打通隧道	tunnel
[化]使饱和	saturate
猛烈袭击	pound
应得	command	deserve	merit
对话	dialog
使放入马厩般的室内	stable
使…结果实	fruit
大吃特吃	pig
捆绑	bind	lash
移走	displace
（使）弯曲	bend	bow
缓解	ease	relieve
暴露	emerge
借给	loan
使结冰	freeze
搞垮	trash
做国王	king
卷曲	crisp	crisp
擦亮	polish
包围	belt	case	circle	lap	sphere	surround
策（马）前进	spur
蜂拥而来	surge
（画像等的形象）美于（真人[实物]）	flatter
想像	conceive	envisage	fancy	fantasy
统帅或指挥	captain
提出罪状（或指责）(against)	article
使向周围扩展	radiate
变得完整和健全	heal
确定容量	gauge
使完全翻转	tumble
残杀	massacre	slaughter
听…忏悔	confess
托管	trust
修饰	qualify	doctor
预约(for或against)	provide
（使）微降	dip
揭露	disclose	nail	out	outing	reveal	uncover	expose
压倒	overcome	overtake	overwhelm
感激(owe的现在分词)	owing
修剪	clip	crop	poll	poll	shave	shear	trim
把…的价值估计过低	underestimate
缩短	clip
再版	reproduce
排斥	reject	shut	exclude
强行推入	thrust
行动	move	act
受锻炼	train
推到	hurl
宴请	banquet
避入安全地	harbor
立…为王	king
订购	order	subscribe
隔离并区别对待（不同种族、宗教或性别的人）	segregate
相等	equal
普及	generalize	generalize
（使）坐	sit
征收	collect	levy
嘲讽	roast
思辩	think
切成片	slice
使屈从	abandon
把…浸入	submerge	submerge
受到震动	shock
刮去…的鳞片	scale
形成大块	bulk
监听	monitor
（太阳）落下	decline
解（闷）	cheat
大力迅速攻占	storm
射（箭）	fire
倾斜	slope	stoop	sway	tilt	tip
反对	object	oppose	resist	except
（把…）编成	weave
远远超过	tower
(to)把身份降至	descend
（植物）蔓延	scramble
用卵石铺	pebble
（用以强调款额、情况严重程度等）讲的是	talk
把…分成小块	plot
签发签证	visa
发出爆裂声	pop
构成…间差别的特征	differentiate
踢蹬	kick
尖响	blast
（心脏等）跳动	beat
把…腾出来	empty
使轮转	cycle
恢复（精神）	renovate
[常用于祈使句中]下去	down
使就任要职	chair
喜形于色	glow
（使）结合	bind
从某种观点来说	speak
叹气	sigh
形成环状	ring
（使眼球）暴突或变大	bug
使（痛苦等）缓和	comfort
成群地移动或出现	swarm
用烟熏	fume
穿上（衣服等）	wrap
从…夺走	widow
有前途	promise	prospect
处于…的最前头	top
（马等）具有某种姿势	carry
设计…的版面	format
把…混在一起	lump
偏航	crab
照管	tend
和解	compound
[航]紧急起飞	scramble
划分	segment	slice	compartment	divide
将（备忘录等）写在板上	tablet
打架	fight	scrap
写作	write
连续猛击	buffet
徒步旅行	hike	walk
运转过快	race
奔波	stroll
用沙哑的声音或嗓音发音	throat
协作	collaborate
详细规划	map
歪曲	strain	wrench	distort
毒害	contaminate	contaminate
（对…）产生不快的影响	jar
使混合在一起	melt
颁与	confer
除（水果的）硬核	stone
勒索	blackmail	bleed	milk	shark
连续	continue
回绝	refuse	refuse
嗾使	hound
周密考虑	contemplate
逝世	expire
用肘推搡着前进	elbow
有咬（或叮）的习性	bite
讲故事	fable
〈口〉炫耀	flash
使发生	effect
使…长成	mature
厉声说话	bark
连结	link	twist
（使）成为空的	empty
放肆	presume
（尤指大口或快速地）喝下	down
囤积	stock
猜测	guess	guess	speculate	divine
在射程上胜过	outrange
精炼	purify	distill
[音乐]乐器等被奏响	sound
[俚语]惨败	bomb
投降	surrender	yield
贬损…	rubbish
具有	carry	have
给（织物）做防护处理	proof
授权给	delegate
发强光	glare
喷	spray
逞威风	lord
使…表面无光	mat
吹奏（管乐器）	tongue
喂	nurse
使…向东方	orient
盖章	seal
喝	eat	taste	tuck
嗥叫	cry
判决	determine	find	sentence
踏实	tramp
自吹自擂	boast
尊重	respect
使严重	compound
使发出	fetch
访问	visit	interview
使浮出水面	surface
使优雅	smooth
伺侯	tend
领悟	digest
附和	side
勾引	score
欺负	rag	spite
讲（道）	preach
使陷入	plunge	tangle
弯身	bend
做实验	experiment
遣散	dismiss
走来走去	pace
（风	chop
给…加薪	salary
充当正面	front
疲倦	weary
烫（发）	wave
起兴奋作用	stimulate
以畏缩的方式去做	chicken
关系到	concern	refer
（尤指在舞台上或摄影机前）扮鬼脸	mug
使发出喀哒声	click
重复强调	renew
大量或奢侈的赠予	heap
剪羊毛	shear
进行选举	elect
识别	discern	recognize	tell	distinguish
蜂拥而入	invade
使腐蚀	corrode
（突然地）行动	pop
迅速移动	course
流出	discharge	flow	shed	shed	well	issue
给…除杂草	weed
使服役	commission
发毕业文凭	diploma
发出光	shine
使简单化	streamline
（在公共传呼系统上）呼叫	page
观光	tour
把…用于(at)	aim
领…到教堂接受宗教仪式	church
对…的真实或有效进行争论	dispute
使受到…的影响	put
减缓	modify
估算	compute	estimate
用匙状假饵钓鱼	spoon
刺破	pierce
恢复健康	recruit
漂白	white
使犯错误	trip
极度轻视	minimize
把…关进牢里	lag
幸免于难	survive
种盆栽	pot
拦路抢劫	hijack
沿（岸）前进	cling
出售	sell	shift
悬挂	hang
附属	hang
用手抚弄	palm
脸红	blush	color	flush	glow
将…分段	paragraph
（轮胎等）爆炸	blow
启蒙	enlighten
在…的基础树立上	ground
对…起诉	law	law
按定量供给	allowance
获取	access
（在餐桌旁）招待	help
横渡	cross
来取	come
（表示应该或不得不做）有必要	need
报信	message
赞扬	celebrate	praise	proclaim	salute
探究	dig	research	explore
把…栽入盆中	pot
入船坞	dock
仔细研究	scope
（使）成为配偶	mate
朦胧	fog
踉踉跄跄地走	blunder
轻快地移动	kite
收藏	collect
惊讶	wonder
使润滑	lubricate
进行奇袭	raid
上演	show	stage	stage
（用关节）连接	articulate
使听写	dictate
搁置	stall	table	table	wait	dismiss
把…关进监狱	jug
把…拼在一起	parcel
毗连	adjoin
批准	approve	confirm	okay	pass	sanction	warrant	adopt
过周末	weekend
平安相处	mix
报道	report
软化	melt	spread
覆盖、穿上	robe
坚持自己的主张	assert
冒充	simulate
鼓起	knob
（在线、绳上）打结	tie
获得利益或财富	get
给…包马口铁	tin
发展	build	develop	evolve	progress	progress	unfold	expand
上厕所	toilet
以捏造不实之罪使入狱	railroad
收成	crop	harvest
投票反对	pill
用火箭攻击	rocket
使黯然失色	eclipse
用直升飞机载送	helicopter
打滑	slide
做梦	dream	dream
启迪	inspire
免费寄（邮件）	frank
使（全国）联播	network
&（把…）联系起来	relate
弄脏	blur	contaminate	dirty	foul	mess	soil	stain	black
声音等）袭来	invade
跳出	bolt
使…宽松下垂	blouse
[电]使绝缘	isolate
付还	repay
流浪	pilgrim
[划船]作尾桨手	stroke
拼写	spell
使…高涨	hike
撞到了桌子	knock
被补偿	balance
爬上	climb
向…吠叫	bay
进行	go	march	perform	proceed	pursue	wage
迅速转动	switch
提供或作为…的证据	witness
缠紧	hug
发怒	anger	fume	explode
使纹理粗糙	pebble
作乐	jolly
封上（信封）	seal
以低沉而有回响的声音发出	boom
出席或知道	witness
传唤	summon
使莫名其妙地出现	spirit
错开时间	stagger
激发	motivate	wake	waken	excite
将…刺入	stab
排泄	evacuate	void
吃快餐	snack
通过双方协议来计划或安排	concert
使烦恼	annoy	burden	oppress	trouble	worry	disturb	fuss
将…译成电码	code
蠕动	worm
使面对面	confront
向…征税	tax
给（某人）零用钱或津贴	allowance
包扎	knot
使坚固或稳固	fasten
提出挑战	challenge
为…裁制衣服	tailor
观察	envisage	observe	sight	sight	tent	view
&记录	record
遮盖	bury	cloak	mat
辨别出	distinguish
使受拘束	cabin
传真传输	fax
在户外用餐	picnic
用训练好的鹰狩猎	hawk
腐化	corrupt
用字母标明	letter
展望	envisage
在…上掘沟	ditch
镶边	rim
显示出妒忌	envy
使（时间）飞逝	fleet
聚集	band	collect	concentrate	crowd	gather	mass	rally
系或用线挂起	string
编寓言	fable
猎兔（通常作gorabbiting）	rabbit
划入底下	submarine
使倾斜	slope	sway	tilt
把…镶入框架内	panel
引起…的意愿	interest
把…存入保税仓库	warehouse
猛踢	hammer
（把准备好的东西）突然拿出来	pop
的确	bet
使安全	ensure	secure
等同于	constitute
使适合（某一特殊用途）	frame
废除	undo	abolish
粗暴地对待	rough
（使）厌烦	weary
肉等）放坏	spoil
鞭打	lash	switch	switch	whip
撕开	slit
给…包上护封	jacket
咳痰	hawk
争执	dispute
用羽毛装饰	feather
埋藏	bury
用雕像装饰	statue
变得文明	civilize
[法]主张	submit
（旗）飘荡	fly
通过通讯卫星播送[传播]	satellite
用泵（或泵样器官等）输送	pump
使…失败	damn
进口	import
（使）装满	fill
[机]给…抛光	finish
乘火车旅行	railroad
（为表示感情或敬意将著作、乐曲、艺术作品等）题献给（某人、某事业等）(to)	dedicate
提出要求	claim
聚焦	focus	zero
指点	prompt	wise
转移	avert
危及	threaten
想弄明白	wonder
归零	zero
被列入	rate
使摆脱	rid
义务服务	volunteer
不翼而飞	walk
喘息	gasp	heave	pant
冒险	chance	hazard
锁上	key	lock
使服毒品	drug
镀镍于	nickel
讲	relate	say	speak	utter
与…部分相同	overlap
供以水	water
乘气球飞行	balloon
涂厚厚的一层	cake
屠杀	butcher	massacre
使犹豫	stagger
改善	better	cultivate	refine	reform	improve	improve
（对…）有利	pay
build的现在分词	building
尤用于英国)使结成姊妹城市	twin
用力使向前推进	probe
（给…）设置障碍	obstruct
猛烈地燃烧	blaze
用钉书钉钉住	staple
（眼睛）闪亮	twinkle
[计算机]开始（应用程序）	launch
（用试探性袭击等）侦察（敌情）	probe
使自己沾染（某些恶习）	addict
营救	rescue
枯萎	die	perish
磋商	confer
成为父亲	father
赞叹	dazzle
使有麻子	pit
使卷入	complicate
渡运	ferry
专心于	concentrate	mind
呜呜作响	sing
为…画漫画	cartoon
当职员	clerk
预先警告	precaution
使分开	part
退子弹	unload
[主美国英语]副修	minor
涂色于	paint	painting
（表示愿望）应当（显示所采取行动正确或明智）	ought
成碟状	dish
唱	lip
对着干	counter	counter
有效	hold
围绕着	fringe
（用…）替换	replace
吃完	eat
熔合（金属）	alloy
售	sell
冲洗（照片）	print
激烈讨论	agitate
发起攻击	assault
开发	build	develop	pioneer	tap
遗赠给	devise
在…处搔痒	scratch
校准	regulate
做出某种姿势	posture
当理发师	barber
（使）与…有联系	attach
使变细	neck
提高肩膀	shrug
（使）增加	exaggerate	multiply
被归入同一类别	coordinate
[俚语]解雇	boot
表演	perform	act
回家	home
伸开	spread	stretch
[美国英语][赛马]得第二名	place
[体]投球	bowl
憎恨	hate
（汽车）换挡	shift
把（地方节目）编排到广播网（或电视网）联播	network
佃出（土地）	farm
操作	fly	handle	manipulate	operate	operate	work	work
猛劲一摔	slam
设计一个版式	format
入迷	fascinate
擦伤	bruise	raw	rub	scrape	scratch	scratch	skin
提拔	prefer
祝福	bless
洞察	detect	pierce
加水稀释	water
摆正	true
当家庭教师	tutor
做手势	gesture
价钱为	cost
感到妒忌	envy
应把…归功于	owing
又来	return
自言自语地说	mutter
高于或独立于（宇宙）而生存	transcend
全速前进	career
筛（煤、矿石等）	screen
戒除毒品	age
[电子学]馈入	feed
长出分枝	offset
（尤指在假日）野营	camp
试探着前进	grope
忙碌	hum
行医	doctor
猛烈敲击	knock
使精疲力尽	exhaust
预备	brace	provide
使发誓	pledge
释放	free	liberate	loose	release
表示鄙视	scorn
禁得起	withstand	withstand
跳水	dive
粘牢	cement
展现	lay	project	stage	unfold
引起发热	fever
传导	conduct
因…而高兴	joy
使显得吸引人	recommend
争取	struggle
借用	borrow
协助	cooperate
完成（困难的事）	manage
在树片上刻痕指示（道路等）	blaze
划掉	cross
让步	give
曲折前进（或延伸）	snake
完结	finish
吹动	blow
用拳打	fist
变暗	dusk
文学张开大口	yawn
[化]使离析	isolate
实习	practice	practise
把…建立在	base
挤满	crowd	jam	overflow	swarm	invade
重复利用	recycle
滤除	filter
认为…比其它更可取	choose
从…上削下一小片	chip
叙述	describe	discourse	phrase	recite	recite	relate
耳鸣	sing
撕碎	tear
用帆布覆盖	canvas
（战争）逐步升级	escalate
变的有缺陷	flaw
描略图	outline
住(dwell的现在分词)	dwelling
查明真相	bottom
〈英〉雇用	fee
唠唠叨叨	jaw
给药	dose
沿…的边	border
可能会	ought
使发光	light
远远高于	tower
交尾(~withsth)	mate
豁免	exempt
奔流	course	flush
（使）下沉	dip
（使）联姻	ally
抽…的血	blood
目的在于	aim
把…远远甩在后面	distance
吃力地往前拉	drag
恳求（原谅）	beg
站在…一边	side
歌唱	sing
烤火	toast
用水坝阻止	dam
转述	retail
自首	surrender
开玩笑	fool	fun	joke	jolly
〈诗〉同“ripen“	ripe
误会	mistake	misunderstand
逮住	collar
&继承	inherit
平安渡过	weather
把…划成部分后分配	parcel
捆紧	rope
（使）变稠或变浓	condense
运载	carry
储存（信息）	store
引人注意	attract
盖章于…	stamp
堆积成堆	drift
主演	star
运转	cycle	operate	power
使露出	bare
变得更光明	lightening
擒住并摔倒一名对手	tackle
使…的髋关节脱臼	hip
潜行	slope	sneak	steal
用蹄触	paw
用不正当手段攫取	shark
（使）向…移动	herd
布置	appoint	decorate	plant	dispose	furnish
得到	derive	get	obtain
皲裂	chap
飞	fly
绿化	green
使成为森林	forest
使（自己）有准备	prepare
盯着他的眼睛	stare
赡养	maintain
愿	wish
使…缠结	mat
使带红宝石色	ruby
掩盖	blanket	cloak	hide	mask	obscure	disguise
交给某人（任务）	task
驱赶	drive
得分	bag	score
使房间通风	air
脱（衣服）	bare
依等级排列	grade
抓取	clutch
压缩	capsule	compress
拍翅膀	clap
密谋坏事	whisper
化装	disguise
随从	tag
与（某人）交战	engage
定税率	tariff
（用绳子）捆	rope
评估	criticize	gauge	grade
向某人点头或摇头示意	motion
制约	condition
上飞机	embark
求婚	propose	propose	court
撤走	withdraw
把…装进袋里	sack
引申	amplify
回想起	remember
流入	feed
把…作成细粒	grain
混淆	mingle
使重视环境保护问题	green
引用	cite	quote	quote	reference	excerpt	excerpt
裁定	rule	rule
同化	assimilate
有利于	help	advantage
给予帮助	administer
盗取	rifle
说明…的原因	explain
资助	endow	aid
出示	produce
辨明	discern
除（草）	weed
解释	comment	solve	translate	account	explain	explain	interpret
使感到羞愧	shame
抹肥皂	soap
请愿	petition
平静	quiet
以一定间隔排列	space
（在品格、价值上）降低	decline
使荒芜	desolate
吐（丝）	spin
梳理	comb
给（马）装鞍	saddle
吓呆	freeze
常去	frequent
漏电	leak
与…结婚	wedding
给…配置人员	man
俚停止	cheese
计数	count	count
使震聋	stun
狂热	fever
在…上撒胡椒粉	pepper
变干	dry
变平	even
使承认	convince
大声说	exclaim
&绘画	draw
变干净	clean
（使）降落	rain
在淘洗中收获金子	pan
系紧	brace
传染	transmit	disease	infect
猛力向前	bull
说（某人）的闲话	dish
打电话	dial
叫	bay	cry
更喜欢	prefer	prefer
叮	bite	sting	sting
精简	compress	condense
使…节节建立	pyramid
标记…的页数	page
挖空（某物）	hollow
言语表达	articulate
应得报酬	deserve
给人以…的指望或希望	promise
被压碎	crush
放松	loosen	slack	slip
叉	fork
成群结队地走	troop
复习	review	revise
下令禁止	ban
提出（报告、要求、申诉等）	lodge
贴上	attach
用桩支撑	stake
忙着做某事	busy
养肥	fat
重叠	overlap	overlap
喊“喂”	hello
偿还	cancel	pay	repay	repay
养育	breed	foster	mother	nurture	raise	rear	rear
惹起	occasion
[法]验证	prove
给…安装铰链	hinge
赋予灵感	inspire
与（某人）离婚	divorce
宣布（结婚等）	publish
打劫	raid
从某时起计算日期	date
使进化	evolve
调整相位	phase
开始讲话	begin
违背	deviate
使变老	grey	age
使（身体各部份）动作协调	coordinate
给…盖顶	roof
〈俚〉占便宜	screw
听说	hear	understand
使困苦	curse
出席	assist	attend	attend
使冻僵	freeze
流泪	water	weep
耐用	wear
（天空）布满云	cloud
组成（一个词）的字母是…	spell
用枝形叶脉刺绣花纹装饰	branch
混合录音	mix
复制	clone	copy	copy	duplicate	reproduce
被用带（或绳子等）系住	tie
缔结	conclude
使意气消沉	oppress
陈设	furnish
随摇滚乐起舞	rock
由…组成	consist	comprise
大声叫骂	hurl
当向导	direct
倾向于（某种观点、意见或态度等）（与to或toward连用）	lean
秘密监视	spy
使渗出	distill
[数学、逻辑学]求…的数值	evaluate
洋溢	glow	overflow
〈俚〉偷	hook
闪光	flame	flare
弹跳	bounce	bound
关上（箱子等）	shut
使紧张	stretch	tension
品质等）跌落	recede
使某人的希望破灭	dish
用混凝土修筑	concrete
变得暗淡	pale
美去市场买东西	market
喊叫	call
受雇	hire
重新取得	resume
判给	award
卸下	dump
作键盘式排字机排字	keyboard
分歧	fork
袭击	assault	storm
以睡觉打发日子	sleep
制定计划	scheme
收获	crop
缩减（工资等）	dock
打赌(on	bet
[法]传讯	cite
当（尤指船上的）工作人员	crew	crew
制定	constitute	draft	make	institute
漫步	wander	wander
加重	aggravate
接连地击打	beat
[电]配电	distribute
将（热物体）放入水中急速冷却	quench
驾驶帆船	sail
怀胎	expect
设计	contrive	design	design	devise	engineer	evolve	frame	plan	scheme	style
&概括	generalize
算得上	count
放大	amplify	enlarge	magnify	magnify
献（血）	donate
用出租车运送	taxi
分辨	tell
盛于碟盘中	dish
表示宽恕	excuse
成为相等	even
用毯覆盖	blanket
武装	weapon
把液体或颗粒洒在…上	sprinkle
平静下来	calm
再演	react
使超然	detach
冲击	wash
冲出	bolt
困难地航行	limp
构思	conceive	design
取暖	toast
作为…的边缘	fringe
补充	complement	renew	supplement	supply	accompany	add
喋喋不休（常与onabout连用）	rabbit
装顶端	tip
轻信	swallow
渐渐被草覆盖	grass
弹吉他	guitar
意识到	perceive
（有时不受欢迎或未受邀请而）参加	attach
清嗓	hawk
使弹起	bounce
摔倒	fall	fell	tumble
冒…的风险	tempt
使一体化	integrate
坚毅地面对	breast
把…免职	dismiss
企求	wish
达到（目的）	fulfill	obtain	accomplish
步测	pace
regard的现在分词	regarding
溺爱坏	spoil
使迷惑	bewilder	bother	fog	perplex	puzzle	sophisticated
咒骂	curse	damn	swear
把…固定	attach
发…薪水	salary
抑制（某事物）	withhold
射出（子弹）	fire
脚尖朝（方向）	toe
[法律]债务转移	delegate
（使）微动	stir
广泛分布	network
查问	demand	enquire
仍然是	remains
称赞	applaud	approve	compliment	love	sing	acclaim	admire
下决心	decide
快速行走	steam
漠视	disregard
[后面省去反身代词]适应于	accommodate
用拱连接	arch
不和谐	jar
&将…连接成网络	network
败坏	sour
算出	do
促销	promote
[棒球]（击球手）击出平直球	line
破壳而出	hatch
作搭车手势	thumb
授予学位或毕业证书	graduate
苛求	exact
与…攀谈	chat
记录（时间或速度）	clock
猛扣（球等）	smash
终结	result
施加	dominate
生长	develop	do	grow
给…装电线	wire
看待	think
将（相片）按比例放大[缩小]	ratio
脱帽致意	cap
（转弯时）倾斜飞行	bank
使成弧形	curve
沿曲线行进	curve
使偏航	crab
示意请求搭便车	thumb
争斗	battle	conflict	contend	contest
减刑	commute
居住于	people
重组	reform	reform
结合	blend	bond	cooperate	join	joint	marry
使通风	ventilate
迫害	outrage
向…征收捐税	toll
使快乐	joy	indulge
预调	programme
饶（命）	spare
挥手表示	wave
指示方向	direct
掩饰	front	mask	mask	mask	sham	veil	disguise
点头答应	nod
咽	swallow
用管输送	tube
（辣椒	bite
使朝上	cock
投掷或滚动（球）	bowl
熄灭	die
否认真实性	refute
使成为神职人员	priest
咬	bite	chew	eat
高声说或发出喊叫声	shout
将…排入日程表	calendar
通知	message	notice	notify	warn	advertise	inform	inform	instruct	intimate
link-搁置	remain
（使）快捷而悄声地移动	slide
逗乐	amuse
封锁	bar	shut
变得随和	relax
提出（控告）	prefer
使服用药丸	pill
装载	charge	load
（月亮）渐圆	wax
禁止发表	suppress
（在意义、价值、效果、程度等方面）等于	amount
使成团块	ball
敢于	dare	presume
联结	connect	join
渗出	soak	sweat	distill
减肥	slim
溢出	brim	overflow	overflow	spill
调停	compound	reconcile	accommodate	interfere
[棒球]（击球手）击出（平直球）	line
把（骑兵）编成骑兵连	troop
眉开眼笑	beam
猛烈抨击	slam	slaughter
用黄油煎食物	butter
断气	expire
前进	head	proceed	proceeding	travel
困住	trap
变大	bug
使苦恼	anguish	curse	torture
悼念	regret
经研磨	mill
把（书边）弄上大理石花纹	marble
面临…	face
传得很远	carry
潜水(dive的过去式)	dove
对（财产、收入等）进行估价（作为征税根据）	assess
跟踪	scout	shadow	slot	tail	trace	track	trail	dog
例示	exemplify
纵情欢闹	racket
伐木	log
如足球和橄榄球踢球得分	kick
指明	designate
使用(use的过去式和过去分词)	used
团结	unite
给…盛（饭、菜）	help
逃掉	flee
喧闹	roar
使即王位	throne
与…相似	parallel
经验	undergo
捐助	contribute
口打败	lick
使恐怖	terrify
使枯竭	bankrupt
用邮船运送	packet
给…加穗饰	fringe
搪塞	fence	stall
调回工厂	recall
提携	collaborate
弄皱	crush
突然发怒	flare
使变瘦	lean
权利、利息）从一人转让给另一人	assign
体积或内容	gauge
熨衣	iron
清理	sweep
通勤	commute
废止	avoid	abolish
使有器官	organize
使成曲线	curve
搏动	pulse
使狂热	fever
注有（或注明）日期	date
严厉对付	punish
变凉	cool
反抗政府	rebel
缓慢行进	crawl
使皱紧	knit
放弃斗争	quit
施肥于	nourish
（马等的）脱缰	bolt
贴连	adjoin
得到补充	recruit
远眺	overlook
变得不新鲜	stale
憔悴	pine
消除（嫌疑）	clear
使担忧	concern
把…定名为	designate
衡量	ponder	scale
伴奏	accompany
商量	consult	advise	discuss
把…刨成（或削成）所需尺寸	dimension
停滞	pause	stand
开放	open
用纸覆盖	paper
（使）登岸	land
分离	detach	part	segregate	abstract	divide	divorce
骑自行车	bicycle	cycle	pedal
吹刮	blow
加盐以调味	salt
登载	print
(paint的现在分词)	painting
允诺	promise
发射电波	beam
报答	render	repay	reward
把…连结	knot
陶冶	mould
用砂纸磨光	sand
惹恼	annoy
起获	seize
聘用	hire
报酬	compensate
作解释	comment	interpret
迅速前行	speed
赶出	exclude
有某种味道	taste
劫掠	raid
砰地关上（门或窗）	slam
埋头于	bury
使分解	resolve
极力主张	urge
吟诵	recite	sing
闲逛	lounge	moon	poke	swan	wander
越轨	deviate
结籽	seed
互换	change	exchange
交锋	clash
出庭	appear
定价	price
磨损	wear	wear
引人注目	distinguish
复原	revive
再保证	reassure
使陈化	age
工作	perform
中途休息	bait
流汗	sweat
捕蟹	crab
（使）进步	progress
整修	renovate
隐瞒	conceal	hide	mask	disguise
穿衣服	clothe	vest
走近	approach
偷偷接近	stalk
用毛巾擦	towel
（使）快速移动	race
斜击	slice
改正	correct	mend	rectify	remedy	square
练习剑术	fence
（雷达）对…进行扫描	scan
表达或指导	gesture
措词	phrase
使变糊涂	bewilder
使出丑	humiliate
拉起	hike
拒绝给（所需之物）	refuse
存留	persist
[棒]作牺牲打	sacrifice
发出隆隆声	boom	thunder
使成小型	miniature
勘探	prospect	test	explore
抽	smoke
获胜	prevail	score	triumph
使伤心	grieve	hurt
〈口〉乱放	shove
查看	see
不断更换	hop
抹	wipe
撒上粉	flour
凝视	contemplate	gaze	peer	regard	stare
使急躁	fuss
翻书（报）	leaf
钉钮扣于	button
入伍	enroll
哀嚎	howl
成玻璃状	glass
（某人）发生性关系	bed
决心要	will
经历	live	undergo
入会	enroll
给…打分	mark
订阅	subscribe
投	cast	pitch
滚球得分	bowl
为…保险	insure
把…登录在账	bill
（向法庭）申诉	petition
遍及	permeate
采访	cover	interview
匹敌	compare
（就某事与某人）达成协议	arrange
议价出售	negotiate
驾驶（飞机等）	fly
爆裂声	crack
步行	pad	tramp	walk
用剃刀刮	razor
使熟练或者精通	verse
转让（权利等）	transfer
瓦解	fry
对。。开交通违章通知单	ticket
[数学、物理学]校正	correct
削去	shave
使多样化	vary
检定	prove
强迫（某人）去某处	haul
意味着	designate	mean	presume	spell	spelling	import
抛	pitch	throw	throw
向…提供（物资等）	supply
当志愿兵[义勇军]	volunteer
[俚语]（尤指盗窃前）探察	case
使了解	hip
使毁坏	perish
具有吸引力	attract
换…的衣服	shift
到达终点站	terminate
在…中[下]布雷	mine
不要	pass
闪亮	bloom	wink
使大吃一惊	startle	stun
（用压穿器）穿孔	punch
给（某人）打电话	telephone
用（床单等）掩盖	sheet
微笑	smile
化脓	matter
（驾舟时）拍打（水面）	pound
加热	warm
鉴别	appreciate
转移（注意等）	abstract
起初是	begin
使悬而未决	hang
刺入	penetrate	stick
留下(remain的第三人称单数)	remains
损害	attack	contaminate	damage	harm	hurt	massacre	prejudice	injure	insult
（寒风等）刺骨	bite
无力支付	suspend
聆听（某人的）忏悔（或告罪、告解）	confess
达到预期的目的	achieve
意味	signify	imply
对…感到同情	pity
反复酝酿	noodle
印	character	impress
（警察、军队等）巡查	police
鸣钟	bell	toll	toll
升	aspire
使有效	confirm
使开始	start
[植]害锈病	rust
轻撞	jog
为…设置条凳	bench
卖	sell	sell	shift
渗透或浸透	soak
装进桶里	barrel
沿着轨道前进	track
黏贴	plaster
[经济学]按生活指数调整（工资、价格等）	index
使孤立	insulate	island	isolate
公开指责	denounce
发电报至	cable
告知	acquaint
爱戴	love
使变干燥	season
呷	sip
把…搁在支架上	cradle
相遇(meet的现在分词)	meeting
将…抽成丝	spin
使出汗	sweat
设想	conceive	conceive	envisage	fancy	trust
吸进（如香气）	breathe
下暴雨	storm
加入	join	affiliate
鞠躬	bow
停止划桨（常用作命令）	easy
做…的主人	master
转学	transfer
鸣	cry
高于	rank
熟化	age
吸	inspire
吹	blow
由于兴奋或激动而感到一种突然的颤动	thrill
发芽	bud	sprout	shoot
解除痛苦	ease
树叶脱落	shed
（使）变窄	narrow
运送	carry	convey	haul	ship	transport
听	hear
强制	oblige
贴现	discount
随风飘动	blow
包锡	tin
拿下（头上）戴的东西	uncover
以短程往复式运行	shuttle
分享某事	participate
受测验	test
开辟	initiate
吐	spit
考试	examine
卖得（好价钱）	fetch
发出刮擦声	scratch
讨论	discourse	talk	discuss
（从…）开始	begin
冲洗	bathe	flush	irrigate
吃	eat	fare	feed	taste
把…贮放在柜内	tank
[俚语]提供免费入场券	paper
瞥见	glimpse
募集	club	collect
突变	chop
闪烁	glitter	sparkle	twinkle	wink
拽紧或扯紧	strain
弄翻	upset	upset
挤奶	milk
观看	saw	view	watch
渗入	penetrate	penetrate	permeate	permeate
按预算拨（款）	budget
侵染	infect
使窒息	choke
猛烈批评	savage
（颜色、声音等）显示	tell
砸入地面	sink
给…加蜜	honey
做加法	add
相识	meet	meeting
持续	continue	endure	last	abide
分组	lot
用钻石装饰	diamond
折叠（衣服的）褶	tuck
使密集	cluster
（利器等）刺进	bite
撕坏	rip
使变暗	blind	dusk
驱策	urge
直竖起	stare
提炼	refine	distill
确定…的数量	quantify
抵押	mortgage	pledge	wage
变萧条	slow
拍…的快照	snap
开收据	receipt
为…编目	catalog
不服从	defy
使面对参见	front
使气喘	blow
腐蚀	eat
响应	respond	respond
使不愉快	repel
向…介绍基本情况	brief
会开汽车	drive
结疤	scar
表现突出	shine
把…漆[画]成木纹	grain
住在小屋里	cabin
把…列为	label
传说	noise	rumor
（意外地、突然地）出现	pop
用力插入	plunge
<英俚>唠叨	rabbit
囫囵吞下	bolt	bolt
排空（胃肠）	evacuate
重整	rally
侵犯	violate	invade
耸立于	dominate
使有特色	feature
归还或偿还	refund
害怕	dread	fear	fear	frighten
不用	spare
大量削减（经费）	axe
[高]低于标准杆数两杆	eagle
（光束、雷达等）扫描	scan
留待	remain	remains
列举	recite	recite	specialize
提出…的条件	specify
追求	aspire	chase	pursue	seek	ambition	court
将（针、线等）穿过…	thread
为…供给资金	finance
省掉	spare
作为借口	excuse
劫持	hijack	kidnap
使逐步升级	escalate
（使）凝结	condense
衰退	crack	decay	fail	fail
覆盖(clothe的现在分词)	clothing
炸（或烤）成褐色	brown
轧花边（在纸币上）	mill
交付	deliver
净赚	net
操控	handle
为…收取费用（常与for连用）	charge
起立	arise	stand
（被）绞死	hang
配置军官	officer
把…放在地上	ground
使延长	spin
成立（军队等）	mount
[摄影术]给…上色	tone
超越	top	tower	transcend	exceed
变明朗	clear
轻视	rubbish	scorn	trifle	disregard
概述	outline	summarize
吹哨子	whistle
坚决认为	insist
把…分成章节	chapter
派遣	detach	mission	send	send
监控	monitor
变得友善或友好	warm
融合	fuse
（击球手因击出的平直球被对方接住而）出局	line
接守	field
使难以理解	cloud
达到顶点	climax
成为…的纪念	commemorate
目眩	dazzle
急速甩动	lash
用或似用带尖的武器刺	stab
挖去…的果心	core
达成…的协议	arrange
被看清	dawn
大声叫	yell
响	sound
判定犯罪	crime
逐渐消逝	fade
使陷于（困境）	land
同行	companion
接上	gear	piece
为…喝采	acclaim
压缩某物使其少占空间或时间	telescope
向…解释	reason
紧附于	glue
快速做[说]某事	gallop
照看	shepherd
拆除	strip	wreck
电汇	telegraph	telegraph
寻觅古玩	antique
躺卧	couch
戳	dig	pink	poke	poke	prick	spear	stab
使…与另一个对等	fellow
液化	condense	dissolve
（为了比较的目的而）把…并列（或并置）	offset
给…装大门	gate
[会]记入贷方	credit
闪耀	flare	glitter	shine	sparkle
为…拔火罐	cup
猛冲	career	dash	fling	storm
耐得住	withstand
过滤	filter	filter
松弛	ease
训练（人格）	mould
焕发活力和才智	sparkle
供养	sustain
向…提供服务	service
使针对	aim
松开	loose	slip	undo
俭省	spare
给…规定路线[次序	route
大范围伸展	sweep
使（各部分）协调	balance
显示：清晰地揭示	communicate
向…致意	compliment	salute
猜想	fancy	reckon	suppose	suppose	infer
保险	secure
拍至	pat
〈俚〉寻欢	cat
碰撞	bump	collide	slam
注册	register	register
称许	approve
在…中占首要地位	dominate
有吸引力	appeal	tempt
发出劈啪声	spit
[古语]冻死	starve
吸取	suck
用电话与（某人）交谈	telephone
罢（工、课等）	strike
猛打	slap
[计]下分支的指令	branch
猛扑	fling
改变	change	change	modify	revise	shift	sway	switch	transform	transform	alter	alter
达…之数	number
娶	married	marry
使前后或来回摇摆	sway
秘密等）泄密	leak
拖地而行	drag
向（车	burden
捣蛋	monkey
抬起	lift	lift	rear
（质量）渐渐提高	accumulate
戏弄	fool	joke	kid	tease
优于或胜过…	transcend
占用	appropriate
某事）看作…	consider
使从事（某种事业等）	engage
欢呼	applaud	cheer	cheer	crow	root	acclaim
呈红色	flush
得益	benefit	gain	profit	profit	advantage
参观	see	visit	visit
承认收到	receipt
约定	appoint	plight	agree
使缓慢地移动	inch
生	breed
[法]提交证据	exhibit
使忧伤	distress
赞许	applaud	smile
东拼西凑地编	quilt
达标	qualify
使某物与…轻轻接触	touch
教训（通常是长篇大论的）	lecture
使决定	determine
使直立	erect
显得庞大	bulk
忽视	bypass	forget	overlook	slight	disregard
跳上[下]	hop
重量为	weigh
（用仪器）瞄准	sight
禁止	ban	forbid	prohibit	veto	veto	inhibit
把（感情、事件等）表演出来	act
请求允许	ask
装捕捉机	trap
得名次	place
达到	attain	attain	attain	build
切细	chop
（使）镇静	calm
射门	shoot
向…提供	feed
问（某人）问题	question
解开或使松	loosen
相平（与out连用）	equal
（常指好天气）突变	break
当作枕头用	pillow
剩下	remain
清楚地发出	sound
潜入水中	submerge
热烈赞同	spark
竭力主张	urge
辞职	quit	resign
使结合成为整体	integrate
转让（财产等）	convey
把…打结	knot
灭绝	disappear
为（管道等）装支管	offset
摇动	move	rock	agitate
使完整	integrate
起源	source
烦恼	bother	bother	bug	trouble
默认	understand
使有名望	fame
制订出	evolve
默许	permit
激励	fire	heart	hound	lash	nerve	stimulate	strengthen	inspire
搞砸	mess
跨越时间或空间	span
拍摄(shoot的过去式和过去分词)	shot
悲鸣	sigh
（飞机）装配平整	fair
左右摇晃	roll
具有…的特征	characterize
喷香水于…	perfume
配备	arm	equip	prepare
古盛传	fame
渴慕	pine
准许	grant	permit
把…编入预算	budget
吹气	blow
（给…）拍照	photo
披露	unfold
（在公共电汽车或火车上）当售票员	conduct
照亮	lamp
共计	foot
（时间）不知不觉地过去	slip
狠打	lay
（矿等）有希望	prospect
确定…的化学结构序列	sequence
大摇大摆	cock
炫耀	glitter	parade	pose	sport	display
link-睡	sleep
相约	date
使焕然一新	refresh
“situate”的过去式和过去分词)	situated
扣住	button	pin	clasp
（电脑病毒）使（电脑的）存储器[数据]受到感染	infect
使达到性高潮	climax
有希望	desire
暗示	breathe	hint	hint	suggest	indicate	infer	intimate
发源	spring
使波动	fluctuate
口装病	soldier
做错事	commit
进展	fare	fare	go	march	move
被机器切削	machine
仇恨	hate
冲突	collide	conflict
取得…的资格	qualify
曲折	twist
应受惩罚	deserve
使（语言）纯正	purify
巡游	cruise	cruise
撕咬	worry	worry
&扯破	rip
歌颂	celebrate	praise	sing
汹涌	surge
推测（马的年龄）	age
off等]出发	set
增加…的艺术效果	strengthen
辅助	minister
用拳猛击	punch	punch
发出（邀请、欢迎等）	extend
使（某人）获得	ensure
交际	communicate
滥用	abuse
逐渐融合	melt
征服	conquer	master	overthrow
转会（尤指职业足球队）	transfer
绘制（一地区等的）地图	map
使固定	anchor	lock	nail	root	stereotype
群集	flock	herd	troop
用篱笆围住	fence
篡改	cook	fake
对…行魔法	charm
割草晒干	hay
了解	discern	grasp	realise	understand	wise
提名…为候选人	nominate
起伏	heave	wave
在…中拥有最重要的位置	dominate
产仔	breed
补偿	compensate	compensate	offset	pay	repay	right
爱抚	caress	pat	pet	pet
用硫磺处理	sulfur
爱护	cherish
（疾病	invade
把…列入表中	calendar
用纽扣装饰	button
打扰	annoy	bother	bug	disturb	interfere	interrupt	intrude	intrude
共用	share
（商业）通知	advise
使相同	unify
打扮	array	deck	dress	habit	toilet	trick
小憩一会儿	breathe
用（床单等）包裹	sheet
对…施加压力	bull	push
谴责	damn	tax	accuse
转给（弊害等）	entail
滴出	drip
为（文学作品）设计情节	plot
铭记	grave
（风、雨等）吹打	beat
反复敲打	buffet	hammer
[法]流通使用	utter
带有某种腔调	tone
变脏、受污染或玷污的	soil
以…为标志	badge
教导	educate	enlighten	school	teach	wise	instruct
使错综	complicate
变得更好	improve
使蒙羞	humiliate	shame
采用	follow	gauge	adopt
迫使…陷于不幸的境地	condemn
缝合	seam
仔细汇报	detail
信赖	depend	rely
优生交配	breed
调弦	string
做苦工	slave	sweat
乞讨	beg
噘起	purse
[证券]从事投机使（证券等）价格上涨	bull
加垫子	pad
[经]构成优先于…的财政要求	underlie
传布（如知识）	disperse
聚积	collect
承认(比赛、选举等失败	concede
偷运	smuggle
复苏	revive
死	finish
（将价格、收入等）划分档次	band
把…藏在心中	bosom
侧转	swing
偷懒	slack
歪	sway
剔骨头	bone
（轻度或暂时地）减少	dip
压痛	pinch
化合	unite
为（某人）写传略	profile
疏远	alien	distance
用泵抽	pump
忍受（常与out连用）	tough
抹去	erase
触怒	offend	provoke	rub
拘押	hold
使腐烂	corrupt
为…建立基础	build
从事金融活动	finance
应获得	merit
过早地考虑（或说、做）一件事	anticipate
改变…以适合(for)	adapt
以掌测量	span
发酵	proof	rise	sour	sweat
（将某物）烤硬	bake
赶紧	despatch	haste
翘起拇指请求搭乘（过路汽车）	thumb
信任	believe	credit	rely	trust
法律或指示	prescribe
发出巨响	crash
质疑	challenge
强加	impose
使…充满香气	perfume
（在文章中）添加	insert
使振作	man	refresh	spirit
（价值	recede
把…挤进	jam
输出	output	export
攫取（常与at连用）	grasp
着火	catch
拉用	collar
打板球	cricket
测量土地	survey
使赤裸	bare
照顾	attend	attend	favor	mind	tend
抽烟	smoke
（使）停止转动	stall
上船	embark
撕成	rip
使搭接	lap
抽水	pump
打包	packet
使变调子	tone
寻求	court
使受电击	shock
遮挡	hide
热烈地拥抱	hug
使分支	branch
宣称	declare	pronounce	say	allege
使上瘾	addict
转化	translate
用无线电波发送	send
系	attach
残害	savage
扭住领口	collar
把（药等）配分剂量	dose
用胶版印刷	graph
强调	emphasize	highlight	underline	insist
打字	type
打孔	blank	punch
（用水泥、胶等）粘结	cement
由铁道运输	railroad
使转移	transfer	divert
（使）碎裂	fragment
倒闭	fail
使适合(fit的现在分词)	fitting
绘画(draw的现在分词)	drawing
有先见之明	foresee
指望	count
移植（器官、皮肤、头发等）	transplant
（人、车等）排队等候	queue
穿成串	thread
脱水保存（如肉或其它食物）	dry
自愿去做	volunteer
当兵	soldier
搁于枕上	pillow
（使…）开裂	crack
衰落	decay	decline	ebb	set
剪切	cut	shear	shear
（因受伤或死等）倒下	drop
削成	chip
操练	drill	drill
使有裂纹	flaw
把。。装入袋中	bag
（如酸）腐蚀	eat
把…弄空	empty
变习惯	harden
以…身份出现	pose
用球板击球	bat
（使）获得	secure
沉思	contemplate	meditate	ponder	study
把…奉献给…	sacrifice
用白垩粉擦（桌球杆等）	chalk
耐贮藏	store
使简易	simplify
常到	frequent
使消失	vanish	dissolve
碰上	front
逐渐消失	blank	melt
重复	duplicate	echo	repeat
叫喊着说	yell
侵蚀	corrode	eat	sculpture
主编	edit
黏附	adhere
以石掷向	stone
议定	conclude
翻页	page
云集	swarm
合拢	fold
使滑动	glide
赢得	earn	gain	pull
溺爱	mother
轰炸	bomb
把…改写成散文	prose
改建（房屋）	alter
由…而造成[产生]	result
得到补偿	recruit
在…上织网	web
合拍	time
证明…合格	qualify
碎裂声	crack
脚步沉重地走（或跑）	pound
（尤指向慈善机构）捐赠	donate
夺得	capture	snatch
（使）流通	circulate
〈古〉烧（酒）	still
使困窘	confuse
感到剧痛	sting
使具有特性	specify
供给	give	provide	supply
使分裂	part	disrupt
茂盛	flourish
给予…专利权	patent
反败为胜	rally
消退（炎症等）	resolve
剪短（尾巴等）	dock
编程序	programme
限定	determine	limit	narrow	qualify	restrain	restrict
排列	array	range	rank	rank	structure	dispose
头晕眼花	whirl
发散	radiate
装潢	dress
使陷于不利地位	queer
（心脏）狂跳	pound
掠过	brush	glance	glide	graze	shave	sweep
规避	evade	evade
吼	roar
加快	accelerate
&到达	get
诉说	complain
深思熟虑	contemplate	reflect
使（自己）沉溺于	indulge
使相交	cross
受考验	test
做成球状	ball
结交	associate
把…弄湿	bathe	wet
用头顶	head
通过叫卖主动兜售（货物）	hawk
付…薪水	salary
&预示（某事）	threaten
预感	anticipate
讲话者暂停了一下	soak
使不透水	waterproof
侵略	invade
用脚踩踏	stamp
排解	interfere
选定（陪审团）	panel
应归功于	owe
在…上镀锌	zinc
把（舵）转向左边	port
横越	voyage
接受训练	train
匆匆离开	despatch
飘浮	ride
辅导	coach
结网	spin
追求某人	romance
使高兴	cheer	delight	flatter	glad	jolly	please	pleasure	rejoice
成团	lump
经得起移植	transplant
起诉	prosecute	prosecute	sue	tag
谢绝	decline	decline
掷	cast
弄瞎	blind
开[乘]汽车	motor
驱进	drive
偷窃	boost	rifle	sneak
齐足（或双足）跳行	hop
接	field	adjoin
得到装备	outfit
由…构成	comprise
使不同	vary
推	bull	poke	push	shove	wheel
节约	pinch	spare
（权利、权威等）归属	lodge
驱除	exclude
与…媲美	parallel
掐	pinch
饰	act
用完	finish
把…置于底座（或基座）上	base
管道运输	bypass
用画笔画	pencil
使再生	revive
吠	cry
饮	drink	drunk
掏	scrape
胡椒等）刺激	bite
滔滔不绝地讲	bubble
（使）混合	merge
[数]作图	construct
（用煤等）封炉火	bank
（雨）降下	rain
偏离	vary
给予（债权人）优先权	prefer
用曲线图表示	graph
给与…特权	privilege
做礼拜	worship
制服	overcome
压低	depress
用桨划船	paddle
逛商店	shop
减弱	appal	kill	recede
涂	apply	spread
用上蓝剂于	blue
不屑做	scorn
打发（时间）	while
拔…的胡子	beard
跟在…后面	tag	trail
重做	repeat
烧坏	burn
（水或其他液体）滴	drop
维修	service
呈现	assume	exhibit
剥夺	deprive	shear	strip
（使）结块	cake
送	send
依从	comply
牵引	tow
收帐	collect
似用泵来拉、转或倒	pump
上涂料	size
约束	bind	constrain	reduce	restrict	school
摆脱	dump	emerge	slip	ditch
胶合	glue
通过设定一时间期限来统治	deadline
搅动	agitate
藐视	trifle
要	want
运输奴隶	slave
减弱…的权势	diminish
猛划船	bucket
切成	cut
含有	drip
皱缩	draw	shrink
使专门化	specialize
杜撰	coin	fable
集中全力于	bend
出游	journey
推迟	delay	wait
剩余	remain
推进	promote	propel	push	urge
预见	anticipate	foresee
谢谢	thank
伤害（感情	injure
列于表上	list
声称	announce	assert	claim	contend	declare
查出	smell
剪	clip	clip
[口语]长时间地思考	noodle
置于球面内部	sphere
变热	hot
（使）熄火	stall
剔	pick
使…成功	prosper
胁迫	blackmail
剁	chop
剃	razor	shave
被重复	echo
出牌	discard
零卖	retail
拳击	box
割开	separate
使跌价	depress
烘焙	bake
宠坏（孩子等）	spoil
使符合流行式样	style
请原谅	forgive
打倒	bowl	fell	floor	overthrow
使目眩	dazzle
使密切结合	knot
突然跳出	spring
剧增	soar
帮助	assist	facilitate	help	support	aid	aid
使中断	halt	disrupt
侵袭	attack	invade	invade
吞并	absorb
使长满苔藓	moss
环绕	belt	circle	ring	wreath
起球	pill
（按照规矩）管理生活	living
为…备马	horse
[棒球]快速传（球）	snap
输入	import	input
朝向	front	front	home
掷（色子）	throw
摆渡	ferry
挖出（孔、洞）	hollow
用滑雪杖加速	pole
竞赛	compete
震动	pulse	rock	tremble
惧怕	fear
购得	buy
分担(in)	share
填满	inhabit
搂着脖子亲吻	neck
为水淹没	flood
使震惊	shock	startle
遭受	suffer	sustain	undergo	incur
批改	correct
直立	rear
放宽	loosen	relax
使关进畜舍（或马厩、牛棚等）	stable
有能力	suffice
申辩	plead
露齿而笑	grin
像猪一样过活	pig
泼出	spill
摘录	abstract	excerpt	excerpt
欢庆	rejoice
（为物色、招募目的）特别关注	rush
反复讲	drum
离弃	abandon
参加电台、电视节目的演出	broadcast
涂改（支票）	kite
报价	quote
选取	extract
给…装信管	fuse
晒太阳	sun
打算或注定要某人成为或做某事	mean	means
去（果）核	core
悬摆	swing
[美国英语]给…开收据	receipt
记述	chart
恢复平稳	right
洗药水浴	dip
倾盆而下	bucket
排掉水	drain
（颜色）调和（与with连用）	tone
胡闹	monkey
（在某地）采取军事行动	operate
抛锚	anchor	anchor
画漫画	cartoon
动力	steam
加强语气	emphasize
使变浅薄	shallow
（钟、表）走快	gain
把…加以艺术乔装	art
蓄长	grow
在…上铺地毯	carpet
玷辱	shame
撤离	evacuate
投票	poll	vote
仿造	fake
巡逻	patrol
坚决主张	argue
毁坏	damage	massacre	wreck	injure
弄斜	incline
喘息(pant的第三人称单数)	pants
把…当作中心	centre
引起…的好感（或兴趣）	attract
将…移交上级法院审理	appeal
使较量	match
开枪	discharge
挥动	flourish
摆船	pole
表示异议（与to或against连用）	except
使运作	work
开发（土地、资源等）	develop
使瘫痪	paralyze
装肋于	rib
变得明朗	dawn
吸收食物	digest
发牢骚	crab	groan	plain
击退	repel
在…打开通道	tunnel
（使）模糊	mist
看起来好像	look
享受	enjoy	pleasure
（书写	white
快速地流动	course
（使）被卡住	catch
给…加大油门	gun
使发抖	shake
感情上变得温和	melt
上涨	advance	advanced
拴住	bolt
拍成	pat
注满	brim
使具体化	embody	incorporate
使冰冷	chill
参加网络闲聊	chat
使对质	confront
联合抵制	boycott
使产生兴趣	interest
提出理由证明	argue
发呜咽声	sob
变钝	rust
演讲	pronounce
制成核正誊本	exemplify
非常多	abound
装满	load	store
划过	knife
区别对待	differentiate
俚增加（饮料的）酒精含量	needle
变矮小	dwarf
出新芽	stock
擦	brush	rub	scrape	scrape	scratch	wipe	wipe
承诺	commit	undertake
怒骂	storm
孤注一掷	gamble
抵抗	resist	dispute
略过	skip
跌倒	fall	tumble
提高	better	boost	elevate	enhance	up
抽芽	sprout
略述	outline
清扫	clean
写评论	review
与…成平局	tie
入学	enroll
摸索	feel	grope
幽禁	chamber
使正	right
用石子扔	pebble
联合	club	consolidate	joint
献身于	attend
指路	conduct	point
提高（飞机乘客、旅馆住客等）的待遇	upgrade
捕猎（动物、鱼）	harvest
表演保龄球	bowl
在…上挑起争论	issue
无意中说出	blunder
使潮湿	damp	wet
（船、飞机等）卸货	discharge
（使）做出决定	determine
妥协	compound	compromise
突然下降	dive
挑剔	criticize	fault	fault	pick	quarrel
卸下货物或其它负担	unload
调整使适应	tailor
跳舞	dance	step
压下	depress
退场	exit
沿…（方向）前进	course
悄悄地行进	ghost
使用铅版	stereotype
挤	crush	squeeze
振作	revive
使相形见绌	dwarf	shame
散步	spot	stroll	walk
使陷于瘫痪	cripple
放下	down
使对照	contrast	oppose
类似于	resemble
伸出	finger	poke	project	extend
呈蓝色	blue
挖	pick
按	press	push
使变重	weight
合伙	partner	partner
求爱	court
涂橡胶于	rubber
排列整齐	dress
（使）流传	circulate
以推销自己的意图）	hijack
（尤指用马刺）策（马）加速	spur
压紧	compact	compress	pack
卷起	comb
解决	concert	cure	decide	settle	solve
集中：稳定地集中或指向：	fasten
详细制定	elaborate
行使职责	function
（狗）闻着臭迹追	road
探寻	seek
使变换	turn
对…做手脚	fake
（使）困难	embarrass
用钻、挖或掘的方式打通	bore
夺走	tear
把…关在房间里	closet
挑起	provoke	shoulder
用…的手套	glove
驱动	propel
审判	judge	try
急派	fling
轻拍	flap
专心致志于	bury
粘贴	paste	stick
轻拂	kiss
以活门调节	valve
选矿	concentrate
口译	interpret
染透	grain
眼花	whirl
翘起	cock
发出（电报等）	flash
在困境中持续下去	rub
开办	start
聚于角落	corner
得知	hear	learn	learn	learned
把…切成片（或段）	section
使浸透	steep
逃离	flee
部分相同	overlap
使互相关联	correlate
苦干	labor
达到（认识、理解或相信的程度）	come
公开展览某物	exhibit
扰乱	undo	disorder
实施	conduct	enforce	implement
（通过努力等）赢得	win
重新开始	renew	renew
把…覆盖在…上(over)	spread
击	striking
接触	contact	rub	touch
使疯狂	mad
凿	chip
用…线缝	thread
给…戴手套	glove
在…挖掘隧道	tunnel
在…之前发生或出现	precede
从事	embark	engage	engage	follow	have	prosecute	undertake
经销	sell
偷听	overhear
被洗掉（通常与out和away连用）	wash
接见	receive
用手操作	handle
使回火	temper
（物体）塌下	give
证明是	prove
准备行动(against)	arm
使失望	disappoint	disappoint	fail	sour
渐进	inch
睡眠状态	sleep
呈现某种色彩	tone
（使）成长	develop
长得健壮	thrive
请客	dine	hostess	treat
（使某物）旋转	rotate
咳出	cough
进入轨道	orbit
芒刺）	beard
行骗	cheat
附加	tag	accompany	adjoin
封闭或限制	chamber
使…变大	expand
引爆炸药	fire
鸣汽笛	whistle
用电车（等）运	tram
清洗	wash
为…而斗争	champion
邀请[常接不定式或从句]	request
勇敢地对抗	beard
以…而自豪	pride
突然大声说出	rap
烧毁	burn	consume
交错而行	cross
使骚动	disturb
割颈杀死（家禽等）	neck
影响	bias	guide	react	affect	influence
争夺	contend	contest	scramble	dispute
使成团	lump
使伤残	disable	invalid
（火车、轮船、飞机等）接受乘客	board
因病而奉命退役	invalid
筑巢	nest	nest
控诉	charge	complain	sue
卷进入	suck
混音	mix
大量出现	bloom
下订单	order
审计	audit	audit
变质	spoil
游荡	float	loaf	swan	wander
发散气体	evaporate
使动摇	fluctuate
猛击	bang	hammer	lash	whale
自负有	boast
使变成银色	silver
送…回家	home
（使）参加比赛	race
蜂拥	pile
浓密（或茂密）地生长	bush
由舆论决定	vote
反映	glass	mirror
〈古〉对…发怒	stomach
定级	rate
使孤单	desolate
炸破	burst
要紧	matter	signify
使生长	sprout
弄湿	dew	wash
重新流行	revive
参加体育运动	sport
使（头脑、神智等）清醒	clarify
漂泊	drift	tramp
绊倒	trip
用魔法变出	magic
（在松软的表面）压印	print
嗡嗡作响	zoom
重演	duplicate	react
击鼓	drum	drum
换算	convert	reduce
奉献	dedicate	devote	sacrifice
干预	interfere
给医嘱	prescribe
懈怠	slack
使高雅	refine
欺负人	rag
（使）长大	age
大量地给	rain
袒护	front
渐盈	wax
审查	investigate
[体]任主要运动员	anchor
下赌注	bet	gamble
游历	travel
使隶属于	affiliate
（使）卷曲	curl
倾向于	incline
进行测试	quiz
作一垒手	single
败坏（名声）	stain
使失色	pale
设计作品情节	plot
改编	adapt
起源于	arise	originate
向…下达简令	brief
（车辆）急驰	hell
使斜靠	lean
变淡	thin
参照	reference
切成薄片	shave
匆忙离去（有时与off连用）	pack
用言语表达	word
&增加	increase
洒	sprinkle	sprinkle
（表示必要或很重要）必须	must
洗	wash
紧抱	fasten	hug	press
搀扶（某人）上下车	assist
铸造	cast
受益	benefit
隔离	segregate	isolate
把…放入或存入仓库	warehouse
醒	wake
血球溶解	lake
吹毛求疵	rank
促动	motivate
扔掉	reject
迅速行动	clip
享用美食	feast
构成	compose	compose	constitute	construct	form	structure
重击	sock
产生回响	echo
使温暖	heat
打捞	drag
想(think的过去式和过去分词)	thought
在…巡回演出	tour
挣得	earn
使（液体）溅起	splash
使激动	hot	thrill
浪费	fool	lose	riot	waste	dissipate
对…进行调查	poll
赐予	endow
搁浅	ground
使休息	rest
拨弄	finger
[航海]用一根杆来推动	pole
用洗发剂洗头	shampoo
使驯服	gentle
使行动起来	arouse
（驯兽）玩把戏	perform
赋予	clothe	endow	gift	vest
恢复精神	refresh
使忙碌	occupy
用爪抓（或挖）	claw
使重新流行	revive
摊开	unfold
抓破	scratch
游行示威	march
蹒跚行进	jog	jog
急忙抓住	grasp
使处于（某种状态）	put
[地质学]变动从而产生断层	fault
发稿	file
把…四等分	quarter
玩耍	play
高视阔步地走	stalk
容易搬运	handle
摘	pick
扮演	perform	play	pretend	represent	act
拉过来	pull
作注释	comment
业务或活动范围	branch
同感	sympathize
评判	judge
同意	applaud	approve	comply	consent	grant	grant	hold	license	side	undertake	accept	agree	agree
（用墙、篱笆等）把…围起来	enclose
拒绝参加	boycott
对…说“但是”	but
使改变方向	turn
调整（或对准）…的角度	angle
喝采	acclaim
报复	retort
评分	grade	mark	score
（使）觉醒	waken
吃得过多	stuff
划分乐句	phrase
联合（起来）（通常与together连用）	band
成为空的	empty
转向左舷	port
隐含	imply
（使）失去（所需要的东西	lose
[电子学]接收	receive
娇养	baby
使处于有利地位	advantage
失效	lapse
合铸	alloy
（使）爆炸	explode
伙同	band
透露	leak
纷纷降落	shower
以笑表示	laugh
挤过去	squeeze
失散	wander
完成或结束	complete
把…硬挤	intrude
以系带系紧	lace
作记录	witness
除去…的灰尘	clean
（使）清醒	sober
预防	avoid	prevent
干涉	poke	interfere	intermediate
[数]化为零	vanish
使挨饿	starve
稀释	dilute
联系	contact	correlate	touch
（使）调和	blend
透彻理解	assimilate
供出消息	talk
放掉气体或水（以使某物运行正常）	bleed
参加辩论、争执或冲突	tangle
[航]加夹箍夹牢	fish
没遇到	miss
拔出剑	draw
处于…前面的位置	precede
发证书给…	certify
[语]修饰	modify
穿越	cross	shear
记载	catalog	record
用天平称	balance
用斧砍	axe
贪吃	pig
认为（某事）会发生	expect
[法]复印	exemplify
孵化	hatch
起锚	weigh
恢复	rally	recover	repair	retrieve	revive	revive
绕着系上带子	belt
放轻脚步走	pad
飞快地带走	whirl
繁殖	breed	reproduce	increase
使（自己）想起一时忘掉的事	recollect
非…所能办到	surpass
变得复杂	elaborate
以灌木（或灌木丛）装饰（或覆盖、围绕、围住、支撑、标志、保护等）	bush
用工具给…加工	tool
迫在眉睫	loom
拒绝给予	withhold
尖刻批评、侮辱	slap
桩顶开花或开裂	broom
推断	compute	conclude	deduce	infer
哀痛	mourn
在…中出错	fault
打保龄球(bowl的现在分词)	bowling
盘问	demand	probe	quiz
使…痛苦	pain
给（动物）驱肠虫	worm
给…安衬里	line
怠慢	slight
尝味	taste
&练习	practise
划（行）	oar
泡	swim
利用	employ	reclaim	utilize	impose
被弄脏	soil
发给…许可证	charter
或出席活动）	come
延缓	delay	ease	postpone	postpone	suspend	wait
尤指服装、颜色等相配	suit
解救	free	save
腐烂	corrupt	foul	perish
依赖	count	depend	lean
斥责	carpet	scold
（比赛中）记分	mark
使跛	cripple	lame
使变苍白	pale
解散	dismiss	dissolve
绕成盘状	coil
捕到	land	spear
抢占	bag	grab
使成圆形	round
使…显老	date
围（围巾）	scarf
来回旋转	reel
（尤指长期地）希望	wait
挖空	scrape
试探	feel
暖和起来	warm
激起性欲	arouse
使（人、举止、仪表等）变得优雅	polish
继位	succeed
（通过努力）到达	gain
用螺丝拧紧	screw
擅离职守	desert
燃烧	fire	flame	flare
停泊	anchor
应付（困难局面等）	manage
执行	conduct	discharge	enforce	perform	administer	execute	implement
应用	apply
艰苦地行走	paw
答复	answer
镀青铜于	bronze
惊醒	rouse
证明（某人）患有精神病	certify
闻到	scent
更（衣）	shift
生根繁殖	layer
穿教服	vest
毁灭	consume	perish	ruin	undo
意指	infer
（使）前进	advance
叫醒	rouse	stir	wake
高视阔步	stalk
事先指导	prime
为雾笼罩	fog
耍花招	fox
往或朝…而去	seek
生小猪	pig	pig
[建筑学]给（房屋）建屋脊	hip
为…费心思	study
使运行	operate
为…提供床位	sleep
咚咚地走	pound
封堵	stem
减轻（病痛、疑虑、恐惧等）	quiet
（使）翻倒	overturn
被举起或抬高	hoist
怒火中烧	boil
陪同	accompany
向…提交文书	instrument
可以追溯的	trace
效仿	echo
泼溅	dash
退位	yield
[化学]使老化	age
（尤指）[棒球]将（球）击中击球员头部	bean
忘记	fail	forget	forget
急速上升	rocket	zoom
给…加煤	coal
纠缠	foul	torment
提出	float	lay	offer	pose	present	render	subject	advance
把…固定在	bed
染污	stain
动员	mobilize
搬动	move
退出（某种活动）	recede
乘热气球飞行	balloon
精心调查	spy
使成块	lump
侍候	attend
作评语	comment
买卖	merchandise	trade	traffic
求助（于）	appeal
使沉默	silence
服药	dose
赡养(+for)	provide
描述	depict	picture	portray	qualify
选择	choose	elect	opt	select
（用仪器）测量	gauge
把…输入电脑	input
奉承	flatter
屠宰	butcher
使成横排	rank	rank
公开宣称	testify
腌制食物	preserve
开始出现	dawn
使充满恐惧	appal
假寐	doze
狠揍	cream
浏览	browse	dip	page
筑成池塘	pond
从事间谍活动	spy
除	ratio
懒洋洋地躺	lounge
使变酸	sour	turn
给…上蜡	wax	wax
[主用于法律]了结	determine
为…报仇	revenge
耍阴谋	intrigue
把…奏成爵士音乐	jazz
提出（问题）	start
终止	cease	cease	conclude	determine	end	lapse	abandon
（景象	greet
使消沉	chill
为…而奋争	contest
使…成熟	mature
指定遗传密码	code
使完美	accomplish
学习(learn的过去式和过去分词)	learned
绕行	round
下冰雹	hail
参拜圣地	pilgrim
握住	hold	hold
梳理（羊毛等）	tease
畏缩	shrink	shy
结合起来	band
辟（路）	chop
使（例如铃）响	ring
不喜欢	dislike
管制	confine	police
浮出水面	surface
以耙子耙平（泥土等）	rake
听见(hear的现在分词)	hearing
说话	talk
（尤指在其他人不成功时）扬扬自得地夸口	crow
给予合法的地位	legitimate
吐痰	spit
用瓦片、瓷砖等覆盖	tile
感动	melt	affect
担任…的职员（或雇员）	staff
反驳	contradict	contradict	counter	counter	retort	retort
迁移	migrate	remove	remove	transplant	transplant
向…祝酒	pledge	toast
使不中用	disable
使分娩	deliver
有益于…	profit
（为购买某物或做某事而）支付	give
（使）联合	unite	associate
收集木材	wood
非正式擅自公开	leak
阻止（敌人）不使前进	bay
刷卡	wipe
磨平	lap
使难解	puzzle
看护	tent
（街头艺人演出后）收拢钱币	bottle
影响（某事发生的方式）	condition
说着玩	joke
呼啸	whistle
被翻译	translate
握紧	grip
看到	lamp	observe
欺瞒	blind
不计	except
使昏乱	dizzy
有益于	avail	avail	benefit	advantage
变得松散	loose
急走	whirl
起始	begin	start
鄙视	sniff	despise
得意于…	pride
昏过去	faint
电传	cable
关	close	close
拉长	prolong
用机器加工	machine
构想	picture	think
请求得到	request
（使）难以区分	blur
搀扶	hand
跳入	plunge
启发	civilize	enlighten
雇用工作人员	staff
[船]使（木板）接缝平滑	reconcile
使凝聚成一团或形成一堆	bulk
优先于(underlie的ing形式)	underlying
看轻	underestimate
[游戏]参加游戏	play
意思是	meaning
附入	enclose
使…居下位	subordinate
思考	debate	reason
镇压	crush	suppress
用肘推	punch
规劝	urge
粉刷	decorate
往复移动	saw
感激	appreciate	owe
明确提出	specify
招待（客人）	help
逗弄	rib
碰巧	chance	happen
（气候、食物等）适宜	agree
担任跑龙套角色	super
做准备	provide
成立	found
澄清	clarify	fine
备以木材	timber
使住临时营房	hut
镀锌于…	zinc
使带有条纹	stripe
对…感到好奇	wonder
变坚实	firm
引起（注意、想像、兴趣）	capture
捉拿	seize
到达	arrive	attain	attain	come	fetch	find	found	reach
脉动	pulse
教	teach	instruct
使起毛	nap
用爪抓	paw
起动	start	activate
钻（孔）	bore
产生…结果	mean
把…品质归于某人	attribute
声明	declare	declare	state	testify
收容	ward
使充满…的气味	scent
热衷于…	launch
将…围起来	rail
给装上羽毛	feather
散去	dissolve
开槽于	slot
布告	notify
把…联合起来	band
快速	smoke
（使）胶	cake
割断…的四肢	limb
（机器等）开动	move
回应	reply
快递	despatch	express
发给特许执照	charter
灌输	sow
使堕落	corrupt	pollute	ruin
选修	minor
留间隔于…之间	space
长皮	skin
&收缩	shrink
保留	hold	reserve	saving	keep
不按规章地偷带（人或物）	smuggle
（在蛋糕上）撒糖霜	frost
&（使）缓行	slow
用姓名的首字母签名	initial
[军]牵制	pin
关好	lock
失败	fail	fail	lose
要价	ask
屠宰（动物）	slaughter
使融化	fuse
〈口〉打	jacket
紧靠…走	hug
在…上结硬皮	crust
（到…）去买东西[购物]	shop
靠近	approximate	approach	approach
鞭策	spur
可用于切割	cut
（食物）吃起来感到	eat
[口语]奔跑	chase
陪伴	attend	companion	accompany
怀有情感	owe
位于…的边缘	skirt
扮怪相	mug
攻破	breach
使摇摆	stagger
（以光线）撒满	bathe
使…上涨	pyramid
暂缓	stall	suspend
强烈要求	urge
使蹒跚	stagger
[园艺学]修剪	train
搭帐篷	pitch
长期榨取（某人的钱）	bleed
使感兴趣	tempt
（用线、绳等）系	tie
突然出现	pop	shot	start
使长满树林	forest
溜蹄	pace
使复杂化(complicate的过去式)	complicated
面对	confront	envisage	face	front
使免受令人不快的影响	cushion
承担（费用）	absorb
相容	mix
原谅	pardon	excuse
教化	civilize
用运货马车运输货物	wagon
宿营	camp
给料	input
生水垢	scale
好奇地查看	sniff
总计达	total
用钩挂	hook
变脏	dirty	soil	soil	black
喘着气说出	gasp
等候	await	wait	abide
刁难	spite
呜咽着说	sob
中断	quit	stop	interrupt
把…对准（某方向或某人）	direct
使用某物为燃料	burn
浸泡	liquor	soak	soak	steep
用杆子击打、戳、或搅拌	pole
趋向（于）	tend
拆移	part
解（谜）	riddle
算为	count
像母亲般地照顾	mother
支配	control	dictate	dominate	govern	rule	influence
向…方向移动	head
追求（常与after连用）	chase
像长筒袜一样抽丝	ladder
怕羞	blush
做证人	witness
用公报发表	bulletin
赊货给…	finance
看起来忧愁（或害怕、愤怒等）	cloud
给…服药	dose
教训	jaw	lesson
（种子）繁殖	seed
剥光	strip
转动	twist	wheel
挤进	tuck	wedge	wedge
进食	fare	fare
乐于接受	welcome
[数学]求…的微分：计算导数或（函数的）微分	differentiate
使贫困	distress
（在文字等旁）标星号	star
[美国口语、俚语]（用抛投物）击或打…的头部	bean
作诗或者从事于作诗	verse
把…延展到远处	remote
低声下气	humble
轻快地走	step	trip
污染	contaminate	dirty	dirty	poison	pollute	stain
严格控制	rein
筹办	stage
担任…的主席	chairman
发音	articulate	pronounce	voice
为…加冕	crown
关进	shut
破裂	crack	fragment
依然	remain
给…加路缘	curb
举办	give
漏水	leak
磨亮	lap
运行	perform	run
略呈波形	wave
使相连	twin
（使）厌恶	revolt
哽咽	choke
意味(mean的现在分词)	meaning
用…替代	substitute
归类	classify	group
变得更窄	narrow
（诗歌）符合韵律	scan
对（做）某事感到厌倦	tired
相撞	collide
收割	crop	harvest
调整步调	pace
组成公司	incorporate
流下	shed
穿梭般来回移动	shuttle
绘制地图	chart
牢记…的宿怨	score
开采	mine	exploit
使沉没	swamp
使皈依	convert
哄传	noise
被评价	rate
自贬	stoop
发表宣言	declare
罚款	fine
吃或喝	touch
追	pursue
移往	migrate
表示深深的遗憾	mourn
是…的后裔	descend
改编（剧本等）	arrange
按类型把…归类	type
爆[突]发	explode
坚决要求	insist
用头顶(head的现在分词)	heading
使知罪	convict
锻造	forge	forge
持枪	port
使登基	throne
零售	retail
使报到	report
虚度	fool	moon	trifle
辩论	argue	debate	plead	reason	dispute	dispute
堵	plug
[医]推拿	manipulate
变红	blush
当心	beware
尽情作乐	ball
[音乐]把（音调）升高（半音）	sharp
传授	initiate
东拼西凑地做	quilt
使复杂化	complicate	perplex
疏通	bypass
[俚语]露出屁股以戏弄	moon
损坏	shatter	spoil
付地租	rent
使依赖	rest
进行试验	experiment
终止(end的现在分词)	ending
看到过	know
使…吃药	medicine
（使）局促不安	embarrass
重要	matter
示威游行	demonstrate
与…接界	border
打瞌睡度过	doze
以…为目标[目的]	aim
使…吃草	grass
（仪表等）指示	register
阴沉	shadow
变卖	realise
〈非〉烦恼	sweat
看	look	view
[牌戏]分	deal
给…穿上服装	costume
分支扩张	branch
顾虑	concerning
允许	consent	permit	permit	admit	admit	allow
有意	purpose
使无情	harden
挺胸迎…而上	breast
用键盘式排字机排字	keyboard
开辟（一小片土地）作为花园	garden
给…提供住房	house
微颤	quiver
劈开	knife	spring
沉没	submerge	swamp
（使）窘迫	embarrass
使（光）色散	disperse
使（袜子）发生抽丝现象	ladder
使失明	blind
困扰	persecute
抚摸	caress
使沉溺	addict
[宗]使（场所等）洁净	reconcile
检查	examine	examine	overlook	inspect
如愿以偿	achieve
换来换去	hop
握成拳	fist
脱落	cast	peel	shed	shell
问…的价格	price
规划	budget	formulate
再开始	resume
使防水	waterproof
监督	monitor	supervise
vi暗示	imply
列队行进	parade	process
挨饿	starve
使挤紧	jam
使受冻	winter
刺激(excite的现在分词)	exciting
听到	hear	hearing
思念	miss
与…相像	resemble
使清新	irrigate
推销	market	sell
诽谤	cloud	wrong
（游戏或比赛中）大胜	waste
（使）痛苦	pain
成为高手（或能手）	expert
守护	guard	ward
过早地提出	anticipate
将…提前	advance
用肥皂擦洗	soap	soap
使不毛	sour
帮助某人做某事	assist
情不自禁地笑出声来	giggle
扭成一束	twist
注视	contemplate	eye	focus	gaze	watch	watch
咕哝	mourn
纺织	weave
弄乱（铅字	pie
让他人照管	trust
（道路或河流）蜿蜒曲折	wander
长出蓓蕾	bud
减速	slack
离开	depart	leave	quit	remove	exit
散发（气、烟等）	spread
（使）分裂	tear
躲进地洞	earth
插嘴	intervene
通行	obtain
使意识到	wake
通过法律手段给（私生子）以合法地位	legitimate
照射	ray	shine
滋养	nourish	nurture
调节…的音调	key
表示轻蔑	scorn
确定	ascertain	determine	name
亵渎	pollute	violate
确实	affirm
使苍老	age
预报	forecast	forecast
置…于岛上	isle
使活跃	inform
will的现在分词	willing
把…在白兰地酒中浸泡	brandy
隐蔽	couch
击晕	stun
加圆屋顶于…上	dome
撞见	discover
猜测（常与at连用）	venture
免除	forgive	free	rid	excuse
侍应	help
品尝	relish	sample	taste
（改变…以）适应	adjust
包上	wrap
营造	build
失足	stumble
急速放置	clap
露营	camp
分类	classify	group	separate	sort	sort
怀抱	bosom	nurse
喂养	feed
迎接	greet	greeting	meet
挤入（人群）	bore
转让	transfer	alien
给…房子住	house
征募	draft	recruit
吹口哨	whistle
驾车转弯	corner
使纷纷降落	shower
发射导弹	loose
聚集起来	mass
大声议论	noise
（使）损耗	waste
定收费标准	tariff
埋怨	quarrel
需要…在场	want
开处方	prescribe
引起注意	notice
对…提起公诉	prosecute	prosecute
无理地对待	wrong
不顾	brave	disregard
适合于（某人）	suit
射击	fire	flight	shot	shot	shoot
射出	jet	radiate
俚〉不忠	cheat
使再次发生	reproduce
美给…涂颜色	color
（牙齿等）咯咯作响	snap
领奏	direct
[法]限定（继承人）	entail
着手	begin	commence	embark	institute
抚养	cradle	maintain	nourish	provide	rear
[棒球]当投手	pitch
给…剪毛（或发）	clip
吹捧	boost	puff
打电报	telegraph
使完全	perfect
给…取名	name
为…提供住处	camp	room
使反感令人不适	offend
使变质	degenerate
建立规定	prescribe
调准（望远镜等）	adjust
听信	listen
使轻松	rest
说谎	lay	lay	story
感到	sense
〈非〉狼吞虎咽	inhale
拖延	prolong	stall
偏向	bend
令人厌烦	bore
蒙上皮	leather
使…确信	assure
休会	rise	rose
对…行凶抢劫	mug
生育	bear
为…举行葬礼	bury
排除	bar	bracket	eliminate	preclude	smooth	exclude
搭乘	ride
立…为王后（或女王）	queen
喝光	consume	drain
提议	move	offer	offer	propose	proposition	suggest	vote	advise
下潜	submerge
作证	testify	testify
（因吃惊、害怕或激动而）猛地一动	jump
比…活得长	survive
雕刻	carve	grave	sculpture
绑	string
狼吞虎咽	wolf
使平坦	even
产生物理反应	generate
拂（一拂）	dust
象脉络般分布于	vein
提高（价格等）	hike	raise
筑（堤）	bank
被撕裂	tear
立志	aspire
（在…中）获胜	win
冲洗（伤口）	irrigate
（如）用网覆盖	network
贴纸	paper
赦免	pardon
对…有益的	profit
吃…吃得津津有味	stomach
要求支付	charge
支吾	hesitate
挽救	save
获得…	win
使接触	contact
缩写	miniature
数	number
使在次级	subordinate
（使）认为	incline
提供正面	front
请教	consult	refer
敢	dare	dare
登上	mount
摆脱掉	shift
有别于	distinguish
从。。除去水	pump
神秘地带走	spirit
领导(lead的ing形式)	leading
强夺	rape
立保证书	recognize
缝缀	stitch
使消散	dissipate
共鸣	sympathize
高兴	joy	rejoice
寻求（尤指供货）的来源	source
（在…上）打洞或穿孔	hole
包起	tuck
代客买卖	job
吸收（液体、气体等）	absorb
到…旅游	tour
扩张	expand
结成外壳	crust
怀疑…有罪	suspect
买得起	afford
充分利用	stretch
给人理发	barber
筹划	stage
尽量使力	strain
对…有不良影响	poison
追溯根源	deduce
给…戴帽	cap
演奏摇滚乐	rock
作为…的示范	example
使卡住	jam
退出	drop	exit
给…起绰号	nickname
作出反应	react	reply	respond
涨价	appreciate
放射	ray
构筑	build
胀破	burst
[无线电]脉冲地调节（电磁波）	pulse
使有资格	entitle
起大浪	surge
准确把…推到预定地点	place
经营农场	farm
吸引或引起（注意、兴趣等）	engage
把…填满	implement
用爪子抓	paw
储存	treasure
发出连续而低沉的声音	murmur
轻松打败（尤指强大的对手）	humble
使受伤	hurt
辨出	discriminate
受到…的极大影响	overcome
使有偏见	bias	prejudice
表示	denote	mark	register
决定或选定	choose
赠送	give	present
供给服装	outfit
作出推论	infer
绊	trip
分发	dish	distribute
（使）平衡	balance
织	weave
当设计师	design
要求收回	reclaim
使知晓	hip
绕	reel	twist
（用牵索等）牵拉	guy
〈数〉约去	cancel
把…撕成条带	ribbon
对…感到愤怒	resent
吸入	drink	soak	suck	suck	inhale	inspire
慎重拟定（计划等）	mature
混录	mix
提到	mention	refer
可长期存放保鲜	store
画	draw	picture
变紫	purple
得	must
瞄准	level	sight	target	training	zero
逃跑	run
(to)使顺从	resign
为…举行社交聚会	party
阻碍	bar	discourage	forbid	hinder	obstruct	prevent	intervene	slow
连续重击	pound	pound
分叉	fork
合得来	click
用模子做	mould
为…安排时间	time
去除	bar	remove
（使…）成对	pair
表现出	show
[主英国英语]复习	revise
保持（头发或皮肤等的）健康	condition
用策略	maneuver
接纳	receive
陈述案情	plead
合群	cooperate
走神	blank
上下或左右移动、摆动	flap
度过夏季	summer
用空调调节（空气）(air-condition的现在分词)	air-conditioning
越境	cross
杀死…的丈夫	widow
使处于某位置	set
换班	relieve
精简（机构）	axe
装上尾巴	tail
被雪阻挡	snow
投射	cast
接来（某人）	fetch
沿着一小径或道路前进	trace
横跨	cross
标注重音	accent
使惊愕	dismay
&放牧	graze
在…上敷贴膏药	plaster
使…活泼	brisk
生痂儿	crust
做安排(for)	budget
娱乐	amuse	divert
统治	govern	king	reign	rule	rule
成功越过	negotiate
守候（机会等）	watch
向…提供住处	accommodate
挑出	elect
使（感官）难受	assault
对光检查	candle
定调	tone
使脱水	evaporate
触发	spark	trigger	activate
消耗精力	tax
污辱	brand	soil	spot
措辞	word
发明（新方法）	father
使变曲	bend
养殖	farm
发出撞击声	clash
使从属	subordinate
担负得起	afford
以…为理由	plead
让…见鬼去吧	rabbit
攻击	attack	strike	tilt
蔓生	trail
使…轰鸣	roar
覆盖	blanket	cap	clothes	cover	cover	hide	overwhelm	plate	roof	invest
美主修	major
为…工作	affiliate
遭遇	encounter	fare	fare
with)	bet
使…受初步训练	ground
企图得到或赢得某物	bid
侦察队两两散开	tail
对…作出解释	justify
醒来	rouse	wake	waken
（使）转向	sheer
逐渐或枯燥地通过	wear
对…评价	evaluate
忙于	address
反射光	shine
否定	negative
把…叫做	term
作重要角色	feature
面向	front	look
像乘自动梯上升	escalate
高速行驶	barrel
对…打招呼	acknowledge
爆炸	blast
&储蓄	deposit	save
文覆盖	clothe
成为成员	enroll
使接受	sell
不得不	have
与…相符	fitting
喷发	erupt
踏平	pad
毒（死）	gas
（使）减少	diminish
缺乏	fail	lack
散发香气	breathe
撕裂	tear
成角度	bend
紧贴	cling
鼓起勇气	nerve
瞧	look	outlook
传送	circulate	deliver	transmit	travel
给…打成包裹	parcel
把…称为	label	term	title
采珍珠	pearl
安全	secure
传递	circulate	convey	hand	transmit
提供纸张	paper
（指委员会或集会）表决	resolve
发嗡嗡声	hum
塑造	fashion	form	model	shape
被人看见	show
使撤退	retire
用火箭运送	rocket
（使）呈（或变成）褐色（或棕色）（尤指日晒或经烘烤）	brown
猛动（头、臂、腿）	throw
血染	bloody
（疾病等）使人慢慢衰弱	prey
交涉	negotiate	treat
记下时间	clock
将…装入密封罐中保存	can
命运注定	portion
携带	carry	pack
使变平	flat
解开	undo
做专家工作	expert
形成一串	bunch	bunch
设法对付	get	manage
兴隆	speed	thrive
说出…的名字	name
查明	ascertain	detect
抓牢	grip	grip
使显得古色古香	antique
调味	relish	season
自杀	suicide
扭歪	screw
误入歧途	deviate
沙沙地响	whisper
详细说明	specialize	specialize	specify
接收	receive
留下	remain
揭开…的盖子	uncover
&将（某物）切开（或分割）	cut
刻痕	score
使富裕	enrich
（使）浓缩	concentrate
交替	rotate	alternate
（开始）被理解	dawn
承担责任	stand
螫	sting
炮击	shell
使免遭损害	cushion
梳妆	toilet
保鲜	preserve
倒抽气	gasp
偶然碰见	stumble
加标题	letter	title
强暴	assault
呻吟	groan	moan
漂流	drift
使调和	coordinate	temper
局限于	confine
与…合伙	partner
拖沓而行	trail
（人）上当	bite
注意	concentrate	look	mark	mind	note	notice	observe	regard	tend	watch
处理或负责	handle
救助	aid
作战	campaign	war
（打）开	open
破坏（品性）	pollute
界分	stake
赫然耸现	loom
混合	blend	mingle	mix	unite	incorporate
检测…的角度	square
使…成为国王的妻子	queen
拨出	appropriate
达到（要求、规定、标准等）	satisfy
举步	step
听到过	know
卷绕	wind
系铃于	bell
喜欢	care	cotton	dig	enjoy	like	love	love
放出气体	gas
汽动	steam
擦脂粉等	paint
再占有	resume
习得	learn
使…干净	clean
与…搂著脖子亲吻	neck
产羊羔	lamb
上胶料	size
吩咐	tell	tell
用洗涤剂洗	shampoo
询问	ask	ask	ask	demand	enquire
错过(miss的现在分词)	missing
用证书证明（或认可）	certificate
用动作（手势）示意	signal
履行（诺言等）	fulfill
把…做成流线型	streamline
投资	place	invest
偷	steal	steal
住	house
排成一行行走	file
显示出	prove
说闲话	talk
继续说	continue
烹调	cook	cook	cook
用管乐器演奏	pipe
抛锚泊船	anchor
固结	concrete
编制	compile
发出…声音	go
让新人初试做某事	blood
（为决定谁先出牌等）切牌	cut
包上或镀上钢	steel
用别针别在某物上	clip
给（某人）放血	bleed
（尤指猎犬等）吠	bay
承兑	accept	accept
详察	spy
盖上	coat
用干草喂	hay
用鼻子品评（酒）等	nose
使冷却	cool
拨电话号码	dial
把…编列成表	list
使杰出	distinguish
留心听	listen
文字等）描写	paint
提出申请	file
在纸上印	print
宁愿	prefer
强制离开	eject
使扎营（住宿）	camp
调换	switch	exchange
举报	report
穿透	penetrate	penetrate
许可	permit	permit
流动	drift	stream
继续处于某种状态	stay
闹着玩	joke	play
给…作序	precede	preface
看见	catch	see	sight	spy
随意摆弄	trifle
搬运	carry	paddle
供给午餐	lunch
复活	rise	wake
排队	form	line	line
表示同情或谅解	understanding
做零工	job
使投票表决	ballot
迟疑	crane
抵消	cancel	cancel	compensate	kill	offset
猛地扯开	rip
投机	gamble	speculate
平息	cool	smooth
喃喃地说	mouth
用土覆盖	mould
使赤身露体	raw
到…之后	last
查找…的地点	locate
贴着（墙）走	cling
使对比	contrast
变松或变得更松	loosen
传开	spread
容忍	brook	endure	sanction	stick	stomach	suffer	abide
装阀于	valve
吹拂	fan
锻炼	school	temper	train	exercise
使感动	move
办理	manage
停车	park	park
使神话化	myth
补充给养	refresh
巧妙地控制	manipulate
把…弄紧密	compact
[印刷]排（字）	compose
（未受伤或只受了一点伤害而）逃脱	escape
坐落	set	sit
[遗传学]比对	map
成圆顶状	dome
使移近	approach
锯成	saw
形容	describe	qualify
咬饵	bite
使淡	thin
与…搭讪（或调情）	chat
打破…的脑袋	brain
面试	interview
用魔法摆脱	magic
气喘吁吁地讲	pant
〈古〉打赌	wage
惊退	shy
发出…的气味	scent	smell
获得安全	secure
使负债务	oblige
夸口说	boast
暴涨	boom	jump
使…柔和	mute
加油润滑	lubricate
用耙子把…耙在一起	rake
流空	empty
（突然地）提出问题	pop
以杆支撑（植物）	pole
发出气味	scent
用…担保	pledge
（从…）获得	source
仔细考虑	consider	debate	ponder
擦红	scratch
测定…的体积	cube
敲钟	bell	ring	toll
开展（活动、计划等）	launch
摘葎草花	hop
在幻觉中看到	vision
在…通行	traffic
冲动的行动	leap
缝纫	needle	sew	stitch
归咎于	blame
失去光泽	fade
缝补	stitch
完成	complete	perform	reach	accomplish	execute	finish
分阶段进行	phase
打信号示意（计程车等）停下	hail
&磨碎	grind
导演（戏剧或电影）	direct
使举止与…相称	act
与某物相撞	knock
去除负担	unload
滚动	roll
恐吓	bully	cow	menace	terrify	threaten	intimidate
看得懂	read
剥削	rack	exploit
搅拌	mill	paddle	stir
（使）急速行进	rush
公认	vote
使布满云	cloud
兑换	change	convert	exchange	exchange
使渗进	saturate
用铁链锁住	chain
使坍塌	collapse
使倒转	inverse
遍布	permeate
顺应潮水航行	tide
驯服	tame
宣布参加竞选	announce
使终止	dissolve
取得	have	achieve	acquire
拱起	arch
责怪	blame	thank
钩住	hook
随意旅行	swan
采纳	adopt
交出	surrender
使（某人）精神恢复健康	heal
铺	lay
砍树枝	limb
细查	scan
未（做）	omit
举起	elevate	heave	lift	lift	up
进入（如油流入机器）	feed
热情款待	entertain	entertain
颤动、战栗或振动	thrill
（思想	ray
铣	mill
（用牺牲等）换取	purchase
[棒球]偷垒	steal
唤起	awake	evoke	prompt	revive	stir
进规定饮食	diet
烘烤（面包片等）	toast
（眼睛等）凹进	retreat
使退化	degenerate
追猎	hound	dog
折磨	bait	bug	devil	grind	prey	trouble
使…朦胧不清	cloud
公布	bulletin	celebrate	proclaim	publish	report
（通常因悲伤）哭泣	weep
偏袒	side	tilt
引来	bring
（使）休息	rest
为…制蓝图	blueprint
以强凌弱	bully
向…道贺	compliment
售得（若干价钱）	fetch
冻死	freeze
印…的校样	proof
受治疗	cure
咕哝地抱怨	mutter
染色	dye
订婚	engage
力劝	urge
证明	argue	demonstrate	manifest	prove	testify	testify	verify	document	exhibit
进行侵略	invade
遏制	contain
（使）呈螺旋（或卷曲）状移动	curl
图谋	devise	mean	scheme	scheme
把…作为故事讲述	story
为（建筑物）揭幕	open
穷追	bay
计划	calculate	design	mean	plan	programme	project	propose	scheme	intend
跳绳	skip
浪）骤变	chop
发出	emit	evolve	send
传播	broadcast	diffuse	diffuse	permeate	retail	stir	export
相信	believe	credit	presume	trust	trust
撅起嘴唇	curl
告知已收到	acknowledge
暂住	lodge
古〉登	aspire
虚构	fable	manufacture	romance	invent
插入	plug	stick	thrust	inlet	insert
[电子学]施以脉冲	pulse
推搡	bundle
画阴影于…之上	shade
适应	answer	belong	match
开	boil
齐声背诵	chorus
（谈话、文体等）流畅	flow
评述	observe
激起…的好奇心	intrigue
亲手写(handwrite的ing形式)	handwriting
料想	reckon
（使）显得矮小	dwarf
（在食物或饮料中）投放麻醉药	drug
辞谢	decline
浪费（时间或金钱）	trifle
吹口哨召唤	whistle	whistle
拍出	flash
帮忙	oblige	accommodate
信奉	embrace	embrace
享有	enjoy
愤慨的说出	hurl
警卫	guard
使着手	embark
溜冰	skate
引起…的义愤	outrage
给予…速度	zip
给（鞋、靴等）穿鞋带	lace
行礼	salute
旨在	calculate
分层	bed
分居	separate
搅乱	upset
窥测	case
指引航线	course
将…高挂	sky
用词	word
遵守	obey	observe	respect	abide	keep
紧密结合的	married
强迫服从	enforce
（因为害怕、兴奋等）急速跳动	race
推测	calculate	figure	guess	presume	speculate	speculate	suppose
饶恕	forgive	spare
&恢复（某种情况或感受）	restore
（为…）服务	serve
把…看作（或分类、归类）	class
生（孩子）	bear
轻轻拍打某人	clap
确保	ensure	insure
把…除名	expel
值得	command	deserve	merit	merit	rate
颁发（或授予）专业合格证书	certify
给…浇水	water
搜寻	fish	search
总共	amount
导出	derive
吐出或呕吐	reject
使知道	wise
被玷污	stain
阻住	detain
熟练	master
以…欺骗	impose
指出	designate	note
发生兴趣	follow
慎重表达	reflect
给（马）扣上马衔	curb
围以栅栏	fence
甘受	submit
奔腾	rush
努力争取	push
装填	load
登广告	advertise
安排…的格局	format
（指引擎）缓慢而困难地运转	labor
服丧	mourn
绘样	draft
（用枪等）打猎	shoot
攻克	conquer
用星（形物）装饰	star
做（…的）先锋	pioneer
位于一队列中	track
电镀	plate
&怒目而视	glare
〈口〉强烈谴责	slaughter
获得	attain	attain	attain	cop	earn	earn	extract	gain	land	obtain	reap	receive	take	achieve	acquire
用意志力驱使（某事发生）	will
华丽夺目	glitter
准备妥	wait
使（精力、金钱等）耗尽	drain
感兴趣	warm
授予…奖章	medal
等于	embrace	equal
意指或意味	intend
喝酒	drink	drunk	liquor	wine
痴爱	spoon
膜拜	god
用带绑扎	band
使苗条	slim
执业	practice	practise
使接替	relay
堆起来或覆盖住	stack
打(strike的现在分词)	striking
进入	enter	penetrate	pierce	access
[橄榄球]接球	receive
奖赏	reward
磨快	grind
轻轻地抱或捧	cradle
凝固	concrete	freeze
挖掘隧道	tunnel
使懂得	wise
使屈服	nod	overthrow
用魔法得到	magic
嵌入	mount	telescope	inlet	insert
中止	pause
结伙行动	gang
淘金	pan	pan
使受益	benefit
用毛皮覆盖	fur
扣球	smash
针对	refer	aim
提供武器	weapon
贡献	lend
依序排列	grade
与…猛撞	cannon
有价值	count	count
在…中加入脂肪	fat
裹起	tuck
干得出色	star
联在一起(to	attach
使翻倒	upset
缝被子	quilt
听任	surrender
可容纳若干座位	seat
强行	bend	force
先于…行动	anticipate
（用枪等）瞄准（与at连用）	level
使入伍（或入会、入学等）	enroll
作废	defeat
召唤	call	summon
听从	obey
颤动	tremble	tremble
公鸡啼鸣	crow
忘却	forget
使一般化	generalize	generalize
和…形成对照	contrast
惊恐	frighten
耸立	lift
美化	ornament
受到（惩罚等）	get
推断出	conclude
强迫	bull	compel	constrain	drive	force	necessitate	oblige
（使）传播	spread
受到强大的压力	strain
打断（别人的话等）	interrupt
给…穿袜	sock
以…下注[打赌]	stake
被雪覆盖	snow
（使）清洁	clean
（尤指）斋戒	fast
弯成曲线	curve
不利于	prejudice
惩处	deal
减去	deduct	subtract
哀号	howl	keen
〈诗	aspire
介意	care	mind	mind
坐电车	tram
蹒跚	reel	stagger	stumble
开会	congress	meet	meeting
组成	compose	constitute
使糊涂	confuse
陷入	lapse
把…编目	catalog
体育运动	kick
把…编入某一班级	class
生叶	leaf
播放节目	broadcast
赚得	earn	earn	realise
似阵雨般降落	shower
鼓起（勇气）	summon
（和某人）性交	screw
冷藏	freeze
获奖：赢得一枚奖章	medal
把…装入盒[箱	box
支持	back	born	brace	encourage	favor	hand	second	shore	side	support	sustain	sympathize	uphold
使纠缠	foul
长胖	flesh
经历…之后还存在	survive
私吞	pocket
爆裂	burst
变得越来越大（或重要）	bulk
乘公交车（或驿车）旅行	stage
撢去	dust
[缝纫]放针	increase
[数]借位	borrow
把…关入栏中	pen
美[证券]（股票）增加发行	split
压榨	milk	squeeze
出其不意获得	surprise
使不见	vanish
在手边	wait
铺地板	floor
油煎	fry
用下巴夹住	chin
与…抵触	contradict
参与	concern	join
留…住宿	room
设法获得	court
使感觉到	put
（愉快而懒散地）度过（时间）（常与away连用）	while
向（某人）道贺	congratulate
使起伏	heave
无意中听到	overhear	overhear
装作	seem
使复职	restore
非正亲吻	pet
使开裂	spring
缚住或扎牢	span
延伸或扩展	string
乱扔	litter
记起	recollect
失去勇气	chicken
把（某人）逐出教门	curse
痛苦	pine
给人看	sport
（行星等）周转	describe
轮流	alternate
高耸	aspire	rear	soar	top	tower
使欢喜	rejoice
考虑	chew	conceive	consider	consider	entertain	esteem	reflect	saw	study	think	weigh	allow
（打）开(open的现在分词)	opening
为…而做研究	research
不再反对	yield
与…搏斗	breast
战栗	shiver
（尤指迅速或随手）放置	stick
乘电车	trolley
划伤	tear
护理	nurse	tend
轻轻摇晃	tremble
把…送入车库	garage
大声报道	cry
（按一定位置或顺序）排序	range
精神上刺痛	sting
协同工作	team
钉牢	fasten
收养	foster	adopt
解（渴）	quench
播撒谷物使发芽	couch
喝（酒）	drink
发光	blaze	bloom	glow	light	radiate	ray
使用工具	tool
降低	fall
闹事	riot
使近亲繁殖	self
寄宿	board
钉住	nail	pin
用墙隔开	wall
需要	ask	claim	demand	demand	necessitate	need	require	want
抓住	clutch	collar	cop	get	grab	grasp	nail
轻微碰撞	kiss
散开	bleed
埋伏	couch
轮换	rotate
毗邻而居	neighbor
使跳舞	dance
使悔改	reclaim
砰然关上	slam
口走	leg
（让动物）吃草	graze
咆哮	bay	howl	roar
向…方向冲去	charge
使习惯于(accustom的过去式和过去分词)	accustomed
品味	relish
嘲笑	laugh	rag	rib	scorn	scout
（用糖煮过以）保存	candy
压制	oppress	silence	suppress
变缓和	moderate	smooth
（股票）上市	float
透过	filter
敬畏（神等）	fear
沿海岸航行	coast
达成协议	bargain	compound
减量	discount
投弹	bomb
主张	contend	deem
接纳新成员	initiate
整合	coordinate
缝合裂口	stitch
经营	deal	handle	manage	operate	run	work
描…的轮廓	profile
预测	anticipate	calculate	forecast	forecast	predict	divine
扔在一边	fling
追忆	recollect
出版（书籍）等	utter
撤销（判决等）	overturn
细察	analyse
钻入泥中	mud
难过	smart
硬挤	muscle
随…之后	succeed
作为…的开端	preface
闪微光	glance
逐渐开始	grow
扮演角色	figure
给（照片）镶框	mat
使发怒	anger	irritate
作草图	draft
把（汽车）开进车库	garage
使服兴奋剂	drug
敲打	beat
放进桶里	barrel
染上（恶习	contract
扎	prick
订约将…收为学徒（或徒弟）	article
使快速移动	thunder
使愈合	skin
显示巨大热情	passion
把…培养为纯种细胞	clone
传讯（出庭）	summon
使闻名	fame
相拥互吻	neck
服侍	minister
记入名册	enroll
祷告	pray
用血弄湿	blood
拿住	hold	hold
卷进	gulf
闲谈	chat	jaw
使陷入困难	swamp
发出回声	trumpet
笼罩	cope	fold
预知	foresee
变坚固	concrete
为…提供所需物品（尤指食物）	provision
禁猎	preserve
给…增加	lend
作仆人（或店员、服务员等）	help
顺从	comply	submit
使文明	civilize
做（动物或植物组织）切片	section
使单纯	simplify
徒劳	waste
使渗透或沉溺	steep
分清	discern	distinguish	distinguish
形成分支	offset
使无能力	disable
（提出建议）应该	must
思索	ponder	speculate	speculate	think	thought
使（机器、计算机系统等）升级	upgrade
用力挤	muscle
贿赂	bribe	buy	grease
给…装入（胶片、狭带、绳子）	thread
制图	plot
碾碎	pound
住宿	room
表演脱衣舞	strip
赞成某提案	second
出力	contribute
剥除	strip
觉得高兴	pleasure
报…之仇	revenge
成双	couple
装扮	play	pretend
特免	privilege
发交通违章传票	paper
接着(follow的现在分词)	following
注水入泵引起	prime
为（文件等）作分类索引	calendar
受损害	suffer
和…比速度	race
（使）减弱	dim
警觉	wake
抵制	oppose	repel	resist	dispute
用针缝	needle
脱轨	depart
承受	receive	undergo	withstand
轮转	cycle
使变形	distort
用外皮覆盖	crust
总结	sum	summarize	top	inventory
赢	win
使加入	interest
装饰或装点	dress
[生]使分裂	segment
进行辩护	defend
使熟悉或适应	orient
把…装入箱（或盒等）内	case
（使）乱作一团	tangle
持久	endure
赶	bundle
引发	trigger
走	foot	step
使颠倒	inverse
提起	hoist
经营…交易	trade
冲刷	flush	wash
接受（礼物等）	take
捆扎	knot	package
恳求	bid	plead	pray	pray
雕塑	carve	sculpture
痛打	hose
赚	earn
作弊	cheat
击（球）入网	net
使守规矩	behave
准备上演	mount
投下	drop
结霜	frost
默想	study
通信	correspond
[国际象棋]使（兵）成为后	queen
使负重	weight
把…列为密件	classify
（用某种语言）讲	talk
证实	confirm	demonstrate	evidence	prove	testify	affirm
死缠着要	persecute
繁荣	blossom	flower	flourish
使苍白	chalk
答辩	answer	plead
减轻	combat	ease	modify	plaster	relax	alleviate	dull
掉换	reverse
受教育	train
查账	audit
与…竞争	rival
打扫	sweep	sweep
就是	mean
读(read的现在分词)	reading
认不出	mistake
落叶	shatter
监视	monitor	scout	watch
测定	monitor
（景色、景致）展现	spread
[音乐]变奏	vary
抖动	quiver
治理	govern	harness
判（某人）离婚	divorce
用探针（或探测器等）探查	probe
（使）成圈	loop
清晰地说明	detail
使象钟状地张开	bell
演习	maneuver
浮现	drift	emerge
为…加油	cheer
做特约演员	guest
研磨	mill
砍倒	fell
乘喷气式飞机	jet
继承	follow	succeed	succeed	ascend
长羽毛	feather
（使）减速	slow
防腐处理	preserve
参加某事	participate
活跃	hum	sparkle	flourish
得到改进	polish
把…藏入地窖（酒窖）	cellar
突然搜查	raid
犹豫	halt	hesitate	hover	pause	stagger	vibrate
烘干	bake	whip	air
分享	share
变黑	black
伸长	crane
按铃	ring
正式指控	denounce
把…装入篮内	basket
使行军	march
用图表示	diagram
将…做成模型	model
主持节目	anchor	host
使混合	compound	incorporate
乘	multiply	ride
（给…）投入（资金）	inject
使复活	revive
给予	lend	lend	offer	pay	accord	administer	afford	allow	extend
（波涛等）拍打	wash
离开原路	wander
（动物）发出刺耳的叫声	whistle
追踪	stalk	trace	track	trail
反复考虑	revolve	revolve
变成粉末	powder
传播流言	gossip
用手势表现	gesture
使模糊	fog
用网捕	net
用夹子夹在某物上	clip
朝圣	pilgrim
“precede”的现在分词	preceding
写短文报导	paragraph
为…发愁	worry
任职	occupy
预述（条件等）	premise
使坐落在	site
形成图案	pattern
经光照耀而)闪闪发光	twinkle
（与某人）商定（某事）(withapersonabout或forathing)	arrange
（使）成环	loop
舍弃	fail	leave
混进	mingle
使迅速发展	boom
使充满（感情）	fill
[古]诅咒	ban
写信	write	writing
努力争取(for)	labor
[诗歌用语]表露强烈感情	passion
扔弃	dump
签订协议	article
使温和	gentle
伤害	harm	knife	pain	wound
换衣	change
（尤指事前）向…介绍基本情况	brief
仓促（做某事）	hurry
记载日期	date
赌输赢	game
亲身经历	experience
使…停止运行	shutter
在…跳来跳去	hop
给…用上蓝剂	blue
摆动	lash	vibrate
伪造	fake	forge	forge
用意	mean
想要	care	fancy	like	offer	require	will	wish	wish
提出…为前提	premise
（指飞机）在地面或水面滑行	taxi
排水	drain	displace
放慢	slow
促使	bring	force	motive
尽情地玩	ball
立契转让	deed
鼓掌欢迎	applaud
（颜料、墨水或染料等）化开	discharge
呻吟着表示	groan
夺取	capture	grab	seize
[化学]老化	age
崩溃	collapse	fall
&考虑	consider
旁听	audit
悬吊	swing
领导	lead	lead	top
使突出	emphasize	project
修改	amend	modify	alter	doctor
惊跑	mill
死亡	die	perish
变换	transform
变糟	suffer
捐（血）	donate
装支管	offset
校准（机械等）	adjust
继续进行	pursue
给予…庇护	refuge
尤指用样品来检验	sample
使度过夏季	summer
精选	concentrate
开…的玩笑	guy
失去	lose
成群结队而行	flock
从事…的研究	research
精通	master
把…涂染成红色	ruby
&胶合	gum
为…辩护	justify	plead	advocate
上（路）	join
提纯	concentrate
颂扬	sound
工资等）	freeze
交给	hand
基于	base
交结	twist
使扫兴	chill
使轻快地移动	twinkle
把…分成份额	portion
使和解	reconcile
公开讨论	ventilate
发笑	laugh
排队前进或列队而行	procession
演出	appear	play	play	stage
加啤酒花于	hop
以雾包围	fog
用电报发送	telegraph
宣布…不能使用	condemn
使朦胧	shadow
感到高兴[快乐]	delight
结算	foot
渐渐变得	grow
向…提供消息	source
尖声唱	pipe
嘎吱嘎吱地擦	grind
付出代价	cost
尤指人体）	hug
（使）成球状	globe
弄成…	mean
（在舞台上）表演	act
（突然地）伸出	pop
为…设（平）台	platform
使入迷	entrance
翻译	translate
策马飞奔	spur
（使）平静	calm
在…之前发生（或出现）	preceding
弄上斑点	spot
切下	slice
视为	deem	deem
制作节目	programme
试点	pilot
刺穿	pierce
急伸	fling
决意（做）	design	purpose
[商]抛售（证券）	unload
把…关入栅栏	barrier
激烈抨击	savage
扭曲（某人的面孔）	screw
使（火车）出轨	ditch
起绒	tease
计议	contemplate
忘掉	forget
散置	sprinkle
冒蒸汽	steam
发生共鸣	relate
容量	measure
给…装上空调	air-conditioning
递送	deliver
跃过	hop	leap
收费供…膳宿	board
打折扣	discount
冲孔	punch
交换	change	change	commute	reverse	switch	trade	exchange	exchange	exchange
回转	return
使聚集	cluster	huddle
成谷粒	grain
打点于	dot
（使）工业化	industrialize
为…干杯	toast
扭转脖子看	rubber
撞击	bowl	smash
跨坐在…	stride
接待	receive
（使）变高	heighten
求援	reinforce
坚忍	persevere
采取某手段或方法应急或作为对策	resort
使迟钝	blunt
使舒适	comfort
焙	roast
使逐步上升	escalate
使或使能飞行	wing
给自己装上教服	vest
耗费	use
罢工	strike
抱起	raise
（尤指罗马天主教会）忏悔	confess
[印刷]浇铸（铅字等）	type
使得到	earn
（使）缠结	tangle
趋势	trend
对…加注释	note
告状	sneak
控告[后面常跟从句]	complain
跪	kneel
跨	stride
把…记入日程表中	calendar
安放	site
创造	coin	contrive	create	father	invent
胡思乱想	wander
使神魂颠倒	fascinate
怀孕	conceive	conceive	expect
把（牛马等）联套在车上	team
跳	bounce	bound	jump	leap	skip	spring	trip
把…作为攻击目标	target
奋起	rouse	stir
在…处狩猎	hunt
勒住马	rein
跃	spring
发给…养老金[退休金]	pension
顺利到达	win
〈美俚〉打	poke
（一声音）淹没（另一声音）	drown
闻	smell	sniff
吸收	assimilate	digest	drink	incorporate
跑	leg	run
冻结（存款	freeze
屈服	cave	stoop	surrender	yield	yield
模拟	simulate
[医]会诊	consult
使站立	stand
给某物加玻璃	glass
使…成为泡影	shatter
打（领带）	scarf
下药	medicine
不受约束地表达	loose
液体等）漏出	escape
结束	cease	close	close	conclude	determine	drop	end	ending	terminate	top	finish
保存	hold	preserve	save
卡住	lock
奋斗	contend	struggle
堕落	corrupt	degenerate	ruin
耗损	wear
讲话	word
镀铜	copper
使休克	shock
指定	appoint	prescribe	prescribe	specify
为…申辩	excuse
唤醒	arouse	awake	revive	wake	waken
[冶]把…包铜	brass
述说	announce
使想起	recall	remind	suggest
婉拒	decline
曲解	misunderstand	torture	distort
某事）如何	consider
哭着说	cry
剪开(scissor的第三人称单数)	scissors
适应于	adapt
使产生裂缝	seam
使熟练	perfect
使（某物）更明亮(lighten的现在分词)	lightening
消费	consume
透气	air
&杀死…	kill
闯入	horn	intrude
有滋味	relish
割[打]开…取[放]液体	tap
再现	reproduce
节要	excerpt
使着迷	fascinate
键入	key
增殖	increase
申请	apply	apply
给…穿铠甲	harness
归结为	result
使皱起	knit	purse
决心	decide	resolve	willing
叹气地说	sigh
处置	dispose
（英）把（酒钱）记于（某人）账上	chalk
翻新	refresh	renovate
实现预期的结果	achieve
消失	blank	disappear	evaporate	faint	flee	vanish
使头晕眼花	dizzy
使著名	distinguish
（持续地）苦干	pound
做宣传	advertise	advertise
申诉	complain	complain	plead
误导	cheat	deceive
迅速扩大	explode
飞过	wing
发出喀哒声	click
买卖或卖保险	insure
用皮带抽打	strap
撤职	displace
（在台上）演讲	platform
驶过	voyage
助长	facilitate	forward	promote
拧紧	pack
发出尖锐刺耳的声音	scream
朝某一方向前进	strike
属于某一特定时期	date
插入插座	connect
（使）相抵	balance
润湿	bathe
合格或成为合格	qualify
囚禁	cell	pen
准备（攻击或迎击）	arm
振翅而飞	flap
概括	generalize	sum	abstract
当主人	host
感到抱歉	regret
[机械学]用夹具（或抓具等）固定	dog
掘沟	trench
诱骗	trap
活(live的现在分词)	living
以环连结	loop
正常运转	spark
播种于	sow
依附	adhere
想到	dream	dream	recollect
设置	site
（液体）变得澄清	clarify
成功地应付	cope
切开	carve	section	slit
使消释	resolve
做	be	make	perform	act	do
包含	comprehend	contain	embody	embrace	comprise	include	incorporate	incorporate	involve
常常	used
认出	recognize	spot
解答	answer	solve
把…归档	file
漏嘴说出	blunder
走私	score	smuggle	smuggle
打补丁	patch
用枪打猎	gun
密切注意	watch
达到（目的、要求等）	win
探讨（与of连用）	treat
注定	doom	fate
上弦	string
在乎	care
充满	burst	drip	overflow	abound
砰砰作响	bang
掠夺	rape	rob	rob	sack	spoil	spoil
遗传下来	descend
借口	pretext
受冻	frost
给…加上外套	lag
不赞成	object
相当	become
使（眼球等）左右转动	roll
使繁荣	boom	speed
给…上油墨（以供印刷、签订合同等）	ink
[音乐]以降调唱（或奏）	flat
追溯	retrospect	trace	ascend
再对…进行保险	reassure
自然反应	behave
攀登	breast	climb	climb	scale	scale	scramble	scramble	ascend
划（船）	pull
筑墙围住	wall
杂交	cross
不正当的获得	steal
航行	sail	sail	voyage
在…中开采	mine
（从市场调研中）得出所预测的结果	research
错过	lose
兴盛	thrive
（使）晒成棕褐色	tan
比较	compare	compare	confer	confront
[医学]测定（血型）	type
将…拖上岸	beach
排列成行	line
作出庄重有约束力的誓言	pledge
互相影响	interact
盖（土）	earth
使不利	handicap
在液体中浸泡	steep
给…穿盔甲	mail
打垮	murder
加工	manufacture	process
交谈	interface
使广为人知	broadcast
航海	ferry
（人）生活在厩一般的地方	stable
接壤	bound
抓（捋）住…的胡子	beard
融入	merge
使（水与气体等）分离	trap
拒绝	deny	negative	refuse	reject
除清	evacuate
印刷等）留出空白处	white
花费	cost	spend	expend	invest
（在某物上）镀银	silver
造成缝隙	gap
使颠簸	jog	jog
反击	counter
修订	amend	revise	revise
（美俚）使被处电刑	fry
（使）穿上长袍（或浴衣等）	robe
啰啰唆唆地讲	prose
抖（掉）	shake
[法]确认	confirm
宽恕	pardon	spare
治疗	help	remedy
创作出版	author
（故意）降下	drop
&（使）光滑	polish
把动物放养在	people
成为搭档	partner	partner
踩离合器	clutch
踩	step	step	tramp
站在…的前头	head
与…离婚	divorce
安定	fix
竖起	cock
整队	form
锻炼（身体等）	prepare
成为阻碍	hinder
离开(leave的过去式和过去分词)	left
使…入座	chair
将…放置在某处	park
变成灰色	grey
作图	describe
[印刷]对齐	register
给…加防护罩	shield
（使沿某方向）快速移动	zip
向…报警	alert
执行牧师职务	minister
把…撞击成（某种状态）	knock
骑	ride
校准（常与for连用）	correct
使渐进	edge
获名次	place
磨	mill
（跌倒或碰撞时）起缓冲作用	cushion
用刻刀作装饰画	style
借进	borrow
替人代笔	ghost
给…加压力（或应力）	stress
使分叉	branch
激怒	anger	flame	needle	tick	aggravate	outrage
使具有特征	character
讲演	address
用对话表达	dialog
激起	flame	fuel	prompt	provoke	sow
招展	stream
急于接受	grasp
躲避	cheat	duck	evade	hide	refuge	shelter
使冒风险	gamble
卸船	discharge
游手好闲	fool	loaf
校正	rectify	update	adjust	adjust
来	arrive	come	get
婚礼	wedding
自夸	boast
孤立	isolate
鸣叫	blow
尤指通过想象地	spin
若隐若现	peer
穿透某物	permeate
突然失败	crash
介于…之间	intervene
拍翅	drum
在市场上出售某物	market
着重	emphasize
用野餐招待	picnic
亲吻	caress
（使）同盟	ally
变结实	compact
使（小鸟、小鱼、小虫等）孵出	hatch
草率地行事	huddle
胜过	best	surpass	worst	excel
夸示	display
飞快地移动	rocket
点燃	light	light
剥夺权利	ban
散布于	dot
探测	probe	explore
充满（激情）	swell
变空	hollow
生薄膜	film
[篮球]走步	palm	travel
剥落	chip	peel	peel
使平滑	smooth
哄抬证券价格	bull
满足（欲望等）	feed
使凄凉	desolate
密谈	whisper	whisper
密谋	cook	plot	plot	scheme
标以记号	tick
忘了带	leave
（使）变脆	crisp
做女服务员	waitress
against	bet
锻炼身体	train
使成寡妇	widow
使滴下	distill
供…住宿	quarter
激动	vibrate
成蒸汽上升	steam
贴标签于	label
列入	list
雇用	employ	hire	recruit	retain	staff
给予（重视、信任、价值等）	put
（用建议、指示、有益的情报等）指导	direct
对…犹豫	hesitate
悬而未决	hang
跺脚	stamp
强制发生	compel
精巧地制作	craft
上镜头	film
指挥	boss	command	lead	officer	preside
把（农作物等）晒在场上	field
使工作	work	work
脱离	deviate
使落空	disappoint
移民于	plant
[美国俚语]（尤指在商店）行窃	boost
呈送	submit
（指男性）和（女性）交媾（美式英语）	ball
估价	assess	cost	esteem	estimate	evaluate	prize	rate	value
接防	field
浸湿	saturate	wash
穿（靴）	boot
以信号告知	signal
倾听	listen
为…请客	party
回收（废物）	reclaim
寻找	hunt	look	quest	seek	sniff
用降落伞降落	parachute
（重量的）增加	gain
散布	circulate	shed	sow	distribute
毁坏（建筑物等）的内部	gut
破浪前进	plough
倾吐	unload
倾向	trend
变憔悴	peak
毒死	poison
跑过	course
用垫子作装饰	mat
认购	subscribe
飞腾	soar
体现	shape	interpret
觉得	feel	feel
假称	pretend
刺伤	prick	stab
使更难于理解	confuse
发出嘈杂声	hum
清楚地和清晰地讲	articulate
（玉米）处于长须的阶段中	silk
以瓶盖密封	capsule
为…铺平道路	pave
贯穿	permeate
使和好	reconcile
把…算作	rate
敲击	pop	stroke
连打	drum	drum
支配（词或短语的形式或用法）	govern
[美国方言]从…恢复过来	over
用障壁等)围住	pin
使成功	speed
缠住	possess
抢劫	pill	rob	rob	spoil
反响	reply
作出前提	premise
改变…的大小	size
贴壁纸	paper
荒废	rust
在表面工作	surface
蜂拥而出	spill
缚紧（某物	hug
使上涨	kite
开火	fire	loose
润滑	lubricate
廉价卖出	sacrifice
相同	match
培土于…周围	hill
环绕轨道运行	orbit
&参考	refer
在（酒）中加料	dose
空运	fly
遗落	forget
堆叠	pile
互动	interact
获得学位	commence
减息贷款	discount
使受皮肉之苦	hurt
被认为	rate
附上	attach
给（一部乐曲）配上声部	voice
使心烦意乱	upset
（尤指生气地）猛扔	fling
合伙经营	pool
留着（胡须等）	wear
使摔倒	down
（乐师）弹拨乐器	noodle
使熟化	age
分派	assign	detach	allocate
[数学]分解…的因子	factor
用钱	spend
排出（气体等）	expel
彻底打败	cream
保佑	bless
压迫	oppress	squeeze
发生	arrive	be	become	happen	occur	originate	pass	result	stir
引证	cite
（使）被钩住	catch
优于	precede	surpass	excel
赞助	sponsor
以…为参照	orient
标示	flag	indicate
堆积	bank	load	accumulate
使集合	mass
bear的过去分词	born
以梁支撑	beam
缓慢地行进	creep
把…敲平	spread
（使）发生联系	associate
回响	ring	sound
够用	last
躲藏	hide
[微]使细菌分离	isolate
使染瘟疫	plague
（给…）注射（液体）	inject
使乘船	ship
引诱	bait	lure	tempt	induce	invite
传阅	circulate
叫喊	shout	yell
盘算	contemplate	debate
镀	plate
用帷幕分隔	veil
加背书于	back
劝告	argue	caution	counsel	recommend
抑制	arrest	dam	damp	refrain	restrain	stay	tame	inhibit
[体]成功击中	connect
[机]铣出…的轮廓	profile
介绍	present
松散地垂挂	bag
打猎	gun	hunt	hunt	shot
给…上学	school
行动矫揉造作	camp
使加入工会	organize
提名表扬	mention
保持	maintain	observe	preserve	remain	remains	retain	keep
关注	attend
抱怨	beef	complain	crab	groan	moan	moan	rail	rank	fuss
镂刻	chase
伸展	stretch	stretch	display	extend
结队	troop
在…上装钮扣	button
眼睛）焦点[焦距]以便看清	focus
（使）撞毁	crash
抛洒	shower
thouart即youare	art
向…挑战	challenge	defy
抹辣味料烤制或煎煮	devil
喋喋不休	jaw
榨	squeeze
为…祈福	bless
成为	be	become	get	go
打听	enquire
写字母于	letter
使开化	civilize
小心探索着前进	nose
[医]显示需要做…的治疗	indicate
投票表决	ballot	vote
发出砰的一声	bang
[印]蒸洗	full
使发脾气	rouse
预言	predict	predict	predict	divine
动员…（提供帮助）	recruit
发送信号	transmit
（嗓音）突变	break
比方说	say
记入名单内	list
消磨	cheat	fleet	while
堆积（柴薪）	cord
提倡	pioneer	advocate
以谋略达成	intrigue
强迫退休（并发给退休金）	pension
发嗖嗖声	sing
灌溉	irrigate	irrigate
刺探	poke
超出…的限度	transcend
经历过	know
小刀等）	shut
近似于	approximate
把…放在后面	postpone
喷出	eject	jet	puff	puff	well
授权	legitimate	vest	warrant
合计	amount
嚎叫	howl
使丧失	cost	deprive	rob
拍照	snap
专心	bend
心跳停止	arrest
通用	obtain
勒缰绳使（马）停步	rein
引起性欲	sex
使宿于营中	camp
（用长布条）缠绕	bind
闪闪发出	twinkle
认罪	plead
指派	constitute	designate	ticket
&穿长袍	gown
清除	erase	strip
学习	learn	learn	learn	do
（使）浮动	float
整枝	training
拐骗	kidnap
由吹口哨而发出	whistle
暗杀	assassinate
艰难度过	survive
使合法	legitimate
挑鱼刺	bone
急行	speed
用X射线拍照	radio
把（食物）切成小方块	cube
使喜悦	entrance
[体]到终点	finish
（使）分离	separate
不同意	differ	frown	quarrel	veto
翻书页	page
建立或展示联系	relate
替换	change	replace	displace	exchange	substitute
群聚	cluster
风化	weather
忍住	suppress	withhold
通过吸吮的动作产生声音	suck
搀杂	doctor
使…在饭店下榻	hotel
&推理	reason
伤心	grieve
把…拨给	allocate
[常用被动语态]（作为结果、情况）伴随	attend
贴糊墙纸	paper
作…演习	drill
可使用	wait
提高（设施、服务等的）档次	upgrade
使打开	open
加载	load
吵闹	racket	row
（把…）打包	pack
玩味	digest
积累	accumulate
排出	flow	exhaust
宣扬	boost	preach	advertise
受惊	startle
（鸟）鸣	sing
住在牢房或小室中	cell
受到赞同	commend
过一夜	overnight
（沿特定路线）行进	proceed	proceeding
（试卷）改错	correct
在…旅行或旅行到过…	journey
认为某事[物]属于某人[物]	attribute
被领悟	dawn
哼唱	hum
使折磨	torment
挖掘	dig
在…殖民	people
用颤抖的声音说出	tremble
演说	discourse	speak
退却	retire
俚走开	split
存在	be	lie	obtain	exist
乘直升飞机	helicopter
力求	bid	strive
连累	compromise
涨大	balloon
计算	calculate	cast	compute	count	figure	number	reckon	reckon
淹死	drown	drown
接着	follow
剥皮	peel	shell	skin
描写…的特征	feature
给…定位	position
转化或者被转化为焦炭	coke
暂停	pause	suspend	suspend	interrupt
认识到	know	learn	realise
使开花	flower
竭尽全力	lay
突然不见	vanish
急剧下降	dive
使有安身之处	home
使或变的紧张	tense
开拓	pioneer	reclaim	exploit
涉水	paddle
使很冷	chill
使融合	fuse
嬉闹	fun
（尤指）批评	judge
制作…的录像	video
使感到不适	irritate
测验	test
律师等）做助手	devil
回顾	retrospect
连在一起	couple
使丢脸	humiliate	reproach	disgrace
记于卡片上	card
&共有	share
使坐	set
用…照射	beam
暗中破坏	cave	undermine
使欣喜	delight
鸟滑翔	plane
避难	refuge	shelter
适于	lend
淹没	flood	flow	overflow	overwhelm	sink	submerge	submerge	submerge	swamp	swamp
愿意	care	will
稳而快地行驶	bowl
充当顾问	consult
产（后代）	breed
以小圆点标出	dot
商讨	deliberate
断言	assert	claim	protest	protest	affirm	allege
使…结盟	league
扯掉	tear
做代理商（或管家）	factor	factor
附着于	cling
出奶	milk
把…编入索引	index
冲掉	flush
使（桨）与水面平行	feather
口忍耐	tough
用于转述)将	would
消遣	ball
开导	channel	enlighten
在最后一刻因胆怯而退出了	chicken
激发…的感情	heat
拍击	slap
放(set的现在分词)	setting
积极地寻找	hunt
落后于	lag
使（某人）行动和生活不正常	handicap
祈祷	pray	pray
进行战斗	war
换挡	shift
正恢复（适当的状态或位置）	recover
乘汽车	auto
涂污	blur
变得	become	go
别住	pin
猎获	bag
调整	concert	correct	manipulate	regulate	square	tune	adjust
使阻塞	foul
[宗教]引领	prevent
缩小	contract	diminish	lower
&（一端固定地）飘扬	wave
划（乘）独木舟	canoe
欣赏	appreciate	dig	enjoy	relish	admire
使结成一帮	gang
把…绘入图表	graph
发出声音	noise	utter
把…分成块	junk
细看	eye	scan
环绕…	border
爬坡	ascend
掌（舵）	steer
不做（应做的事等）	skip
偿清	quit	extinguish
注满（玻璃杯）	charge
作检察官	prosecute
劳驾	pardon
想	judge	pant	think	want
使纠纷	tangle
使形成（或弯成）角度	angle
俚拍…的马屁	soap
扫略	scan
[电]整流	rectify
使…有病	disease
强求	exact	persecute
略读	skim
焊接	weld
使求助于	refer
把…堆成小山	hill
（公开地）严厉批评	rap
好奇地引颈而望	rubber
弯腰	bend	stoop
扣上钮扣	button
给（电池）充电	refresh
取来	fetch
（因干了蠢事、失去良机等）对（自己）生气	kick
哭诉	sob
〈口〉无耻地胡搞	brass
没收	seize
使…长满草	grass
给…画侧面图	profile
文件、协议等（因到期而）失效	expire
除去…之种子	seed
通告	advertise
偷看	peep
经常	used
开车	tool
（因寒冷或害怕）蜷缩	huddle
保护	field	preserve	protect	roof	safeguard	secure	shelter	shield
[用于祈使句]走开	off
使忧虑	exercise
告发	denounce	finger	peach	prosecute	report	tell	inform
走过	over	pass
出面	intervene
丧生	perish
走运	bull	luck
[口]打败	best
制订	forge	prepare
迂回行进	weave
猎杀	hunt
列出	list
依附于	cling
固定	anchor	fix
生小羊	lamb
乘船旅行	ship
涂以灰泥	plaster
发起	source	initiate
使困累	hamper
用桶运	bucket
使纷纷落下	snow
羞辱	humiliate
窥视	peep
排气	exhaust
[经济学]生利	produce
定睛地看	eye
开瓶	crack
烘	bake	roast	whip
咆啸	roar
口述	dictate	dictate
取得（权力）	assume
（使）转变	convert
〈俚〉苛刻的对待	shaft
（通常在户外）在烤架上烧烤	barbecue
扩散	diffuse
形成概念	generalize	generalize
使热情	warm
沿着一条路走	track
恢复（元气等）	rally
紧紧抱住	prison
打草图	outline
避开（某人）	shy
使…成为必要	necessitate
为…编码	code
发现(find的过去式)	found
笑容满面	beam
订契约	contract
使失败	destroy
在…中搀以杂质	alloy
巩固	cement	consolidate	strengthen
给（鞋等）修理后跟	heel
谨慎使用	guard
泄露机密	spill
使弯曲	curve	nod
使习惯于	condition
泄密	tell
固执	persist
挽住	link
弄坏	break
尽力	endeavor
调整（频率）	tune
叛逃	defect
进行旅馆式办公	hotel
波动	fluctuate
嗅	sniff	sniff
急速流动	rush
应受报答	deserve
带来	bring
使…烦恼	pain
用围栏围	rail
出让	concede	spare
下判定	find
（用海绵等）洗	bathe
受惊吓	scare
[体育运动]阻止（对手）得分	blank
遵照	conform
扔（或踢）到…距离	carry
剽窃	borrow	pirate
给…发电子邮件	e-mail
牵着（动物）走	walk
标示于图表上	plot
训斥	lesson
锻制	forge
眨眼	wink
充实	reinforce
互助	cooperate	network
尖声喊叫	scream
定居	locate	settle
楔入	wedge	wedge
取走	cop
空转	race
使循环	revolve
使…昌盛	prosper
领唱	direct
调整（眼睛或者镜头的）焦距	focus
除去（锅上的）水垢	fur
采取	take	adopt
依靠	depend	hang	rely
用锯	saw
排便	stool
嚼碎	grind
潜入	duck
给…暗示	cue
巡回	circuit	tour
典当	pledge
开刀	operate
（儿童向成人）打小报告	sneak
打手势	motion	motion	sign
证明合法	justify
比拟（常与to连用）	compare
预料	anticipate	expect
开创	carve
提出异议	represent
用车搬运	van
显眼	stare
庇护	harbor	roof	shelter	shield	screen
舐	suck
疏导	canal
舔	lap	lick	tongue
相连	communicate
预约	reserve
与…矛盾	contradict
[音乐]升音演奏（或演唱）	sharp
抽样调查	sample
给…装齿	tooth
（使）结婚	marry
使消除疑虑	reassure
在…加糖	sugar
校订	edit	revise
认识	know
拥护	advocate
尖叫得使变…	scream
标价	price
参加	assist	attend	enroll	enter	join
改观	transform
厌倦	weary
商议	confer	consult	treat
圈出	circle
分配	assign	deal	portion	share	allocate	distribute
(from)起源（于）	descend
生活	live	exist
拥抱	embrace
使免遭损失	rescue
随声附和	echo
上市	ship
行进	make	steer	travel
涂以树胶	gum
（植物）开花	blossom
使碎裂	shatter
撞碎	crash
致力于	attend	lay	aim
行过	do
执行遗产管理人的职责	administer
分散	scatter
使成玫瑰色	rose
（指潮水）退	ebb
重振	rally
（如用铲、锨或推土机等）挖掘	dig
担任	play	assume
使（双手）成圆状托起	cup
投（资）	plough
否认知情	deny
收录	embody
使成紫色	purple
点头	nod
[古]批评	tongue
（使）轻松	relax
变得轻松	relax
作为示范	represent
抽出种子选手	seed
船驶往	head
损伤…的体面	reproach
烘制（木材等）	fume
移动	draw	maneuver	migrate	move	run	displace
搂抱	nurse
凋零	die
摇晃	dance	reel	rock
打杂	job
查阅	refer
用肘推挤（另一人或另一些人）	elbow
头晕	faint
张开	gap	open	stretch	yawn	expand
使恶化	deteriorate	aggravate
处在	sit
当机务人员	crew
匆匆地写或画	dash
使没落	ruin
指示	denote	dictate	show	indicate
碰见	discover	encounter
（使）跌落	lower
预兆	token
遏止	stem
接触（某物）	meet	meeting
扭曲	distort	distort
下客	discharge
抱住	fold	hug
（足球、曲棍球等）防守	defend
使曝光	expose
使编织（或交织、缠绕）在一起	lace
把…奉献（给）	devote
吓唬	cow	terrify
（使）成为中心	centre
变弱	flag
使有兴趣	entertain
辨识性别	sex
整理版面	justify
（为成就或成功）感到高兴	congratulate
使与…连接	put
使作出（某种反应）	send
给…交代任务	mission
倒立	stare
封爵	create
苏醒	stir	wake
对照	compare	confer
使结合	approximate	bond	combine	adjoin
卸货	dump	unload
枯萎：枯萎	blast
弯成弧形	curve
作记号	mark
叫卖	hawk	cry
（使）结交	mix
回想	recall	recollect	recur
使形成池塘或水洼	pool
经商	merchandise	trade
求教于	consult
乱演某角色	guy
把衣服缝得宽大	full
使（肠）通畅	loosen
恨	hate
（变得）灼热	bake
从…去掉水分	dry
用热蜡除去毛发	wax
使成群	herd
用真空干燥剂干燥	vacuum
腐败	spoil
&原谅	forgive
(will的过去式	would
（使）颠倒	reverse
打瞌睡	doze	nap	nod
垄断	corner
向（水手或划手）发出停划命令	easy
使愤怒	provoke
冻坏	frost
拒绝…占有	deny
使历时过久	overtime
（在乐队里）当指挥	conduct
相通	communicate
变酸	sour
（打字时）击打键盘	stroke
（让对方注意）听着	listen
发射	discharge	emit	launch	project	radiate	shot	transmit
轰隆隆地快速移动	thunder
做出诊断	diagnose
下赌注于	back
放弃	drop	quit	render	resign	surrender	yield	abandon
提供线索	key
指控犯罪	crime
用矛刺	spear
保持健康	keep
暂代他人职务	supply
倾斜后又复平衡	balance
（特别表示因成功而）处于有利地位	laugh
分成区	zone
出租	lease	rent
使…承担义务	commit
啼叫	cry
活着	breathe
乘车	tool
把光射后	shine
（使）加快	accelerate
失去健康	invalid
大屠杀	slaughter
诊察	examine
通敌	collaborate
知道	know	know	wise
私下抱怨	murmur
记下（欠账）	score
使跳跃	bound	leap
抽出…的精华	distill
将…塞进	crowd
用围巾[台布]围[盖]	scarf
撰稿	contribute
把…处死刑	butcher
使钝	blunt
说长道短	gossip
估计成本	cost
为（船舶）引航（或操舵）	pilot
（健康状况等）变差	slip
（使）倚靠[支撑]	rest
脱皮	cast
施加影响	impose
使排出	sweat
贱卖	slaughter
洋溢着（某种感情）	bubble
同…处于交战状态	war
放火烧	torch
盘绕（通常与over	wrap
演示	demonstrate	show
宽容	spare
（使）扩大	exaggerate
吹微风	breeze
扳上扳机	cock
使流出	drain	sweat
使明确	define
奏幻想曲	fantasy
迸发感情）	explode
救援	rescue
使优美	grace
殴打	buffet	plug
居住	dwell	dwelling	live	living	abide	inhabit	inhabit
蒸馏	still	distill	distill
订立演出契约	book
慰问	console
（私下）提问	interview
以微笑完成	smile
(on)袭击	descend
按比例（或平均）分配（利润等）	average
联盟	associate
够支付	buy
注意到	notice
举止粗野	rough
系牢	fasten
化成油	oil
感到震惊	shock
照料	nurse	tend	tent
深深打动	pierce
赞美	bless	love	magnify	praise	sing
提示	hint	prompt	intimate
给以荣誉	honor
歇歇气	breathe
（鳞屑）脱落	scale
仗恃	rely
纠正	mend	remedy	repair	right
球等）乱投	shy
涂粉	powder
尖叫	pipe	scream
为…提供证明	testify	document
失败]	kill
（少量地）吃	taste
意外发现[撞见]	surprise
过活	live
把…引入歧途	mislead
杀死	destroy
得到（报偿）	reap
创制	carve
将（话、批评等）对准目标	level
搜查	search
（给…）覆上一薄层	film
复查	review
达到巅峰	climax
为…装上翼	wing
把形式与作用紧密结合的风格	wedding
匆忙翻找	rifle
装钉（书籍）	sew
看重	consider	value
使发昏	dizzy
预定(mean的第三人称单数)	means
用…交换	commute
背诵	recite	recite	repeat
记着	remember
张紧	tension
咀嚼	chew
结硬皮	crust
成为…的典型	type
谋划	scheme
挡住通路	blank
进入停滞期	plateau
变强	strengthen
在…上加边界	edge
嚷闹	racket
（尤指）密谋	hatch
矫作	pretend
画像	portray
时间过去	elapse
对…感到不喜欢或讨厌	hate
埋入	lodge
塞进	pack
使荒无人烟	desolate
经过	travel
〈方〉雇佣	wage
全心投入	plunge
便于折叠收藏的	pack
把…装管	tube
使蒙受	entail
执行（命令等）	fulfill
[机械学]使承受压力	stress
下令	call
突然跳起	start
留在心中	retain
（在口头或用文字）预言	anticipate
期待	await	count	hope	expect
刹（车）	brake
记得	remember
起作用	act
用子母扣扣	snap
调遣	despatch
使爆炸	blow	burst	burst
（用海绵）擦拭	sponge
使觉醒	waken
在…建桥	bridge
grind的过去式和过去分词	ground
鞣（革）	tan
睡醒	waken
标以刻度	graduate
诱拐	kidnap
用手指触摸	finger	finger
描写	describe
淘汰	eliminate	obsolete
假托	pretext
使疲乏	fatigue
操纵（会议等	hijack
面向…	face
被起皱	crush
结平（账目）	balance
（使）交配	mate
筛分	riddle
为…守夜	wake
使发声	sound
[音乐]（通过旋律、节奏等的变化来）展开（音乐主题、情节、动机等）	develop
发射或使爆炸（武器或爆炸性弹药）	trigger
接近于	approximate
冬季饲养（家畜）	winter
加软衬料后缝制	quilt
给（鞋）换底	sole
炖	jug
起泡	bubble
用驿马递送	relay
捐献（器官）	donate
挑拣	pick
私下说	whisper
男性和（女性）性交	bang
对…有信心	trust
用诨名[爱称]称呼	nickname
相符合(correspond的现在分词)	corresponding
[常后接forth	set
不动	lock
使有条理	discipline	tidy
给（门等）安装警报器	alarm
（使）上下晃动	bounce
打鸟	bird
接纳…为成员	affiliate
种植	crop	cultivate	plant	grow
开始发育	bud
陷害	frame
向后弯	arch
使锋利	edge
渲染	color	romance
输送	carry	convey
正式接受	adopt
显露	reveal	surface
乘地铁	tube
举例	example
担任专家	expert
说出	voice
耸肩（以表示冷淡	shrug
修剪树枝	prime
谣传	noise	rumor
遗留给	entail
摇（出）	shake
参加比赛（或竞赛）	compete
发出闪光	spark
勘测	survey
烘脆（面包等）	crisp
把…装入或装上	load
把高尔夫球打到穴边而未进去	lip
轻声走	tap
铲	spade
调治	nurse
垂下（眼睛）	drop
吹捧（某人）	soap
谈判	negotiate
吸收某人为新成员	recruit
在…事先向…做简要指点	brief
表情夸张	ham
具有重要性	signify	weigh
发出呻吟般的凄切声	moan
试图征服（高山）	attempt
拆毁	trash
手舞足蹈	dance
据说	understanding
作为主人	master
公告	bulletin
进行控告	article
制造帽子	hat
凝缩	concentrate
聘请	fee
用油炸烤炒	fry
形成一组	bunch
冒险行事	venture
做东	host
与…一致	coincide
赶走	frighten	expel
相符	coincide
击毁	blast
使恢复正常	heal
蒸煮	steam
触犯	offend
派人	send
（国家间的）协调	collaborate
后悔	regret
给…戴上头盔	helmet
催促	haste	hurry	rush	urge	urge	accelerate
古温柔地对待	tender
（使）分散	disperse	scatter
交好运	luck
（使）相乘	multiply
偷偷溜走	sneak
解除	relieve	rid
买东西	shop
百折不回	persevere
[音乐]使（音调）下降	flat
画出…的线条	define
把…夹在…之间	sandwich
关闭电流	switch
开路	plough
颠覆	tumble
折扣	discount
送还	return
有重要性	matter
给与…生机	organize
（为特定活动而）使某人装备起来	kit
亲抚	pet
凝结	set
展开	spread	unfold	display	expand
准备（斗争）	arm
发出信息	send
使蒸发	evaporate
用子弹把耙子打成蜂窝似的	riddle
使粗糙	rough
[非正式用语]严厉的批评	pan
定约雇用	article
结成块	lump
开始(begin的现在分词)	beginning
宽免	excuse
给（布）上胶	waterproof
使…成塔尖形	pyramid
踌躇	crane	hesitate
使恼火	aggravate
用拇指翻脏[翻坏]（书页等）	thumb
划船	boat	row
调节	regulate
变慢	slow
（指液体）溅落	splash
形成网状	web
茁壮成长	thrive
（使某物）无性繁殖	clone
（迫切）要求	appeal
将…制成小片或小块	tablet
使恐惧	chill	scare
出神	moon
授予	award	commission	confer	gift	grant	invest
淤积	pool
（对位高权重者）忠诚	owing
抽空	evacuate
检验	review	inspect
以手围绕测量类似测量	span
咯咯地笑	giggle
抽穗	ear
使豁裂	gap
使有玫瑰香味	rose
（数量等）增加	advance
（通常因道义上的原因而）谴责	condemn
扣…的扳机	trigger
垂钓	angle
拘捕	arrest
报告	advise
（使）向下再向上	dip
分成地带	zone
使成阶梯状	step
[逻辑学]用量词限定	quantify
把（汽车前灯）的远光调为近光	dip
接住	catch
架置	mount
兼修	minor
使结束	fulfill
[口语]（把…）装饰得古色古香	art
放进口袋	pocket
变陈旧	stale
乘自动梯上升	escalate
正视	envisage	face
使张开	flare
挤痛	pinch	pinch
上床	bed
签名	sign
致意	greet	salute
使穿制服	uniform
赞成	applaud	approve	consent	cotton	favor	hold	sympathize	uphold
超过	outrange	rank	surpass	exceed
急切（或贪婪）地抓住	grasp
收拾	tidy
调动球员	option
协商	negotiate
释出	liberate
给…安装发动机	engine
觉醒	waken
改变…的基因（或遗传）结构	engineer
做错	blunder	fault
修复	renovate	restore
提供饮食及服务	cater
化妆	paint
创办	begin	found
列队等待	queue
包白铁	tin
纠正错误	correct
由…作中介	agent
（尤指书面）证明	certify
送钱[礼物]给…	remember
给于细部装饰	detail
振作起来	brace
留在岛上	isle
使排成一行或一系列	string
变得病弱	invalid
私运	smuggle
梦想	dream	dream
索价	charge
标出诗歌的格律	scan
敢做	dare
产奶	milk	milk
褪去	fade
使冒泡	bubble
使受洗礼	wash
使成平面	surface
被晒黑	bronze
突然袭击[抢劫]	raid
耕作	cultivate	till
在强压下屈服	squeeze
建立工作关系	network
俚向人扔鸡蛋	egg
顺应	humor
拼凑	patch
放开	release
惠赐	grace
逐渐显露	unfold
察觉	perceive	scent
使震动	jar	quiver	shock
使遭受	cause	expose
悲叹	moan	moan	sigh
使达到高潮	climax
[军]劲降	summon
延长	prolong	extend
参加战役	campaign
向前跌或冲	pitch
改变…的颜色	color
将（头发）剪成不同层次	layer
（表示很可能或符合逻辑）一定	must
（使某物）变短（叠缩在一起）	telescope
擦破皮	skin
时常出入于	frequent
使随潮水漂行	tide
备款以支付	protect
侧身移动	edge
（使）弯成拱形	arch
从…中呷吸	sip
使安静	calm	silence
使变得世故	sophisticated
给…洗澡	bathe
逐渐变平	flat
掌握	possess
便于使（人）自由地来往	frank
探头	crane
（使）节制饮食	diet
索取	claim	levy	request
悔恨	regret
使就职	seat	invest
打赌	gamble	game	lay
使信服	persuade
责骂	rail	rate	reproach	scold
安插	setting
为…提供帽子	hat
短路	short
[法]供述	declare
申报	declare
起风暴	storm
向…欢呼	acclaim
上浆	size
对准	level	adjust
廉价出售（书）	remainder
诊断	diagnose
把衣服穿（在身上）	clothe
匍匐	creep
阻延或推迟	stick
监护	ward
抵御	stand
重压	press
引起	arouse	bring	catch	effect	evoke	generate	grip	mean	means	occasion	originate	pose	produce	raise	underlying	cause	do	incur	induce
（尤指因行为不很明智）使陷入危险	compromise
变坏	deteriorate	recede	sour
假装	fake	pretend	pretend	sham	simulate	affect	disguise
装修（房屋）	furnish
猜	guess	riddle
后退	back	recede	retire	retreat
刮破	scrape
得到工作	hire
[电子学]检波	detect
提高身价	bull
寄给报社	file
任命	appoint	nominate	install
适应环境	conform
带领	conduct	shepherd
倒塌	cave	collapse	fall	tumble
[俚语]逃亡	guy
（口）（用皮带等）抽打	leather
[宗教]积德	merit
豁开	gap
使富有	enrich
熬油	render
经历（常指不愉快的事）	meet
[缝纫]放（针）	increase
补助	complement
认为…起源于	refer
摆放	lie
使…完美	perfect
作东	hostess
预兆：预示或象征	token
举例证明	exemplify
继续	pursue
是…的成员	belong
低声说	whisper
设陷阱	trap
逃走	breeze	desert	flee	guy
提起（诉讼）要求判决	sue
使（植物）朝某方向生长	train
删除	delete	strip
上煤	coal
通过投票[抽签]选出	ballot
发誓	swear
以电话传送（消息）	telephone
把（冰球等）打入球门	cage
承担	bear	shoulder	undertake	accept	assume
脱掉	remove
适宜	become	suit
急切地寻求（常与for连用）	grasp
使腐败	corrupt
辨别是非	distinguish
攻击：严厉批评或猛烈攻击	blast
[电]感应	induce
用花装饰	flower
判归	award
缝针	stitch
随意移动	drift
扬去	fan
乘公共汽车	bus
给…穿衣服	garment	habit
涂油脂于	grease
计扫描	scan
从事劫掠行为	pirate
使（金属）减低成色	alloy
造成麻烦	plague
把…视作	account
饲养	rear
用肉喂养	flesh
渐渐消逝（与away连用）	graduate
使处于	throw
振起	waken
盗用	pirate	pocket
附议	second
摧毁	blast	destroy
克隆	clone
使人发笑	amuse
添加（到某物）	contribute
&抢先	grab
私语	whisper
制作	fashion	produce	tailor
属于…类（或等级）	class
使成脊状	ridge	ridge
（使）疼痛	pain	chap
顶住	abide
（为死者）恸哭	keen
[数学]计算…的平均值	average
设圈套	trap
用油脂润滑	grease
依…为转移	hinge
向…保证	assure
镶嵌	mosaic	mount
哭	cry
流露	beam
研究	observe	read	do	explore	investigate
求出比值	ratio
使沮丧	chill	damp	discourage	depress
填装	prime
解雇	axe	cashier	discard	sack	terminate	dismiss
使（疼痛等）减轻	calm
（使某物）蒸发掉	evaporate
产生	arise	breed	create	evoke	form	give	originate	pose	produce	result
痊愈	mend
（液体）浓缩变稠	reduce
把…除外	except
镇静下来	calm
（道路、物体等）下倾	decline
找…的缺点	fault
使闪烁	flash	twinkle
压破	crush
预订	book	reserve
将…排顺序	sort
补充燃料	fuel
笨重地行走	lump
（为逃税而）隐瞒（部分收入）	skim
用推车或卡车运送	cart
面红	flame
突然发出或出现	spring
办错	blunder
搜索	beat	hunt	rake	range	search
使（希望、爱情等）不复存在	extinguish
归于	assign	remain
非难	attack
出无用的牌	discard
说	go	observe	put	say	talk	tell	utter
使产生效果	work
需要的东西	lack
采集	gather
探望	visit
使组成工会	organize
描述（人或物）的特性	characterize
给…最后加工	finish
[医]使勃起	erect
旅行	journey	track	travel	trip	voyage
把…关进笼内	cage
扫除	broom	sweep	clear
开小差	desert
使反转	invert
夸大	jazz	magnify
〈美〉买卖	handle
拉弯	bend
认可	approve
交托	leave
站着	stand
转换	switch	switch
延期	delay	delay	prolong
供奉	offer
策划	contrive	engineer	meditate	scheme
欢呼或拥戴（某人）为…	acclaim
挥动（棍棒、鞭子等）	switch
一瞥	glance
使阴暗	dull
推理	infer
放荡	riot	dissipate
使有纪律	discipline
加防护装置	guard
录音	record	tape	tape
使布满	pepper
惩罚	reward
使奔跑	run
欲交配	horse
担保	guarantee	secure	secure	wage	warrant
培植	culture	nurture
（数量）逐渐增加	accumulate
输出（思想或活动）	export
修理	fix	mend	mend	patch	repair	doctor
使容光焕发	light
畏惧	fear
使（新闻、报道等）带有倾向性	angle
转动（把手）	wind
集中：显著地注意	fasten
将…列表	schedule
（尤指出售计算机时）赠送软件	bundle
扩大某人的兴趣	branch
作物物交换	exchange
医疗	doctor
争辩	contend	quarrel	reason
走完（路程、距离等）	accomplish
使患热病	fever
使坚定	firm	steady	steel
使坚实	firm
卷成一圈	coil
凿洞	hole
使粒子分散	disperse
折叠起来	fold
加密	code
给…涂蜡	wax
给（门等）装球形把手	knob
link-继续	continue
打杂工	bus
口渴	thirst
提出（离婚诉讼或其他讼案）	file
展览	exhibit
不良安置	warehouse
跟着足迹追赶	slot
（使某物）平静下来	still
（店铺等）关门	shut
（人）变老	alter
使流血	bloody
使（在某物上）保持平衡	balance
抱着	entertain
驾车行驶	drive
（价格）突然下跌	break
如冰雹般地降下	hail
剃须	shave
使有狭缝	slit
使活动	activate
反叛	revolt
使格式化	format
使警觉	wake
不屈不挠	persevere
抱歉	regret
截断	interrupt
参加比赛	play
用符号代表	symbol
照片（模糊）	fog
使破灭	disappoint
下降	down	fall
效劳	oblige
可以	might
参战	campaign
使退役	invalid
达到…的顶端	top
使清楚	clarify	clear
依恋	cling
装货于	freight
起促进作用	stimulate
偷偷地寻找	mouse
把…分等级	rank
通告废除	denounce
出版	publish
设法做到	contrive
造成（威胁、问题等）	pose
活跃起来	brisk	explode
评论	comment	estimate	remark	review
熟虑	deliberate
浅尝	taste
播送	beam	beam	air
制成皮	leather
[棋类]出（子）	develop
抓紧	clutch
受试验	test
绑架	hijack	kidnap
盘绕	coil
（使）加强	heighten
翻找	paw
用独木舟运送	canoe
连续投机	pyramid
精确地解释	define
做好…的准备	ready
诗与…为友	friend
用	use
[俚语]相信	hope
受训练[辅导]	coach
使破碎	shatter
小口喝	sip
愤恨	resent
射击（某人）	gun
起草	draft
保持看法	stand
换衣服（床单）	change
拍摄	screen	shoot	shoot
扯用	collar
分摊	average
把（锚）吊放在锚架上	cat
变硬	fix
使确信	convince	satisfy
铺设	pave
扶直	right
向…传教	mission
变更	change
给…穿夹克	jacket
成为圣徒	saint
猛投	hurl
[自][电子]输入	input
用球棒击球（尤指板球或棒球运动）	bat
成为…的原因	cause
使顺利滑动	slip
打拍子	time
生利	yield
〈俚〉轻轻地说	lip
演（戏）	act
决定于	depend
（使）变暖	warm
极成功	click
转嫁（责任等）	dump
嫁	married	marry
认为正确无误	agree
隐匿	hide	veil
配药	fill
留下疤痕	scar
以…作保	bond
使混乱	complicate	confuse	perplex	disorder	disrupt	distract
作…的切片	section
及时救助	snatch
获得…的版权	copyright
退让	compromise	yield
极为类似	coincide
付保证金	deposit
美[法律]延期	continue
使…有接缝	joint
打高尔夫球	golf
变薄	thin
用篙撑船	pole
使化合	combine
撇去	skim
拒绝承认	deny
设计略图	design
回收利用	recycle
发展成为	amount
供应	provide	furnish
打结	tie
压抑	restrain
对一人讲话时用	art
发许可证	license
宿娼	cat
珍视	prize	treasure
绽线	rip
声援	champion
戴面具	mask	mask
缠绕	curl	lap	wind	wrap	wrap	involve
使留下长久性伤害的痕迹	scar
排齐（常与up连用）	line
缠结	foul	mat
引起不愉快	irritate
把（枪口、照相机、灯光等）瞄准	train
用水砣测深	lead
以（塞子）塞住	plug
净化	clarify	purify
（人）感到苦恼（或烦恼）	eat
使害怕	scare
名列前茅	place
去	go
警惕	guard
使成陈规	stereotype
扭伤	strain	wrench
压	press	press
揭发	peach	split	expose
为演奏谱曲	instrument
跳过栅栏	fence
竞卖	auction
使寄宿	board
使可能	enable
使承担	entail	saddle
（尤指打断后）继续说	proceed	proceeding
摩擦	rub	rub
凸出	bug	bunch
（船）入港停泊	harbor
准予退休	pension
推翻	hurl	overthrow	overturn	reverse	tumble	upset	explode
送交	refer
使平行	parallel
录用	hire
给（窗户或房间）装上帘子	curtain
毗邻	border
打…的头部	brain
迅速行进	duck
诋毁	assassinate
生效	assert
使…成比例	ratio
把…放置成一角度	angle
聚成一串	bunch
侵蚀成	eat
把…插入演出	cue
接到	receive	receive
把…染成蓝色	blue
异口同声地说	chorus
拍卖	auction
喊	cry
怨恨	resent
复发	recur	return
（美俚）听见	ear
矫正	cure	mend
拆（衣服）	rip
（使）腐烂	decay	rot
探讨	treat
谢绝（邀请等）	decline
讨价还价	bargain
用…包裹（或包扎、覆盖等）	wrap
使（船舶）失事	wreck
掩护	shield	wrap
装有钮扣	button
被抛落（地面）	land
行	do
不见	disappear
暴怒	storm	storm
不流露	swallow
叙述（故事等）	relate
（头朝下）跳入水中	dive
[俚语]酗酒	soak
能解决（问题）	manage
堆积起来	bulk
盼望	die	hope	trust	wait	wish
压碎	crush
将（财产等）遗赠某人	will
把…减至最低数量[程度]	minimize
离去	leave
支付现款	cash
来拿	come
加套管于	bush
向往	dream
劝阻	discourage
请（客）	treat
通风	ventilate
[生理学]加工	elaborate
剪短	crop
穿着拖鞋走	slipper
等待	await	wait
使受不了	overcome
驾驶卡车	truck
抵触	collide	conflict
赞赏	admire
把…关在小屋里	cabin
使备有房间	chamber
投入	launch
加速	speed	speed	up	accelerate	accelerate
移种	transplant
拥挤	crowd	jam	pile
容忍（不同意或不喜欢的事物）	tolerate
刺痛	bite	prick	sting
邀请	ask	ask	ask	bid	invite
洞悉	penetrate	penetrate
大惊小怪	fuss
使愉快	jolly
轻松前进	ease
玩	play
沿地面拖动	drag
使铭记	impress
冰镇	ice
使分心	distract
侦察	detect	scout	scout
打卡	clock
快速发展	boom
引路	direct	guide
革除	abolish
采蘑菇	mushroom
（去厕所的一种委婉说法）方便	relieve
共同承担	share
受理	receive
把…浸泡在液体中	bathe
广播	broadcast	air
编制…的目录	inventory
（替作家	devil
追赶入洞穴	earth
猛然或用力推	thrust
上（火车、飞机等）	join
绝望	despair
（用扯碎机）扯碎	devil
（从银行）取（钱）	withdraw
确信	bet	know
隐约地出现	loom
使冒气泡	bubble
[亦作enrol]	enroll
[法]扣押（财物）	distress
跟随	follow	following
离职	depart
忍受(bear的ing形式)	bearing
用于蜜蜂	swarm
[口语、方言]诉诸法律	law
产生（后代）	generate
开（路）前进	chop
使过于劳累	task
管理	boss	control	direct	govern	handle	officer	operate	regulate	rule	steward	supervise	tend	administer
[废语]考察	seek
出价	bid	offer
堵塞	jam	obstruct	stop
符合	conform	consist	correspond	relate	satisfy	accord	agree
克服	conquer	overcome	triumph
延伸	range	thrust	extend	extend
伤害（名誉、自尊等）	injure
与…进行划船比赛	row
想起	recollect	recollect
得罪	offend
变得平坦	level	level
把…归因于	attach
感到极度的痛苦	anguish
下雾	mist
使惊骇	appal
&使成群	group
掏出	fish
下雪	snow
向前推（至下一步）	advance
逼迫	press	press	push	thrust
逼近	verge
殴	poke
使相对	oppose
得胜	conquer
（光）布满	wash
给…装套筒	sleeve
把…放回原位	replace
古使快	haste
娇笑一下	giggle
辨别	difference	differentiate	discern	tell	tell	distinguish	distinguish
调配	mix
配置设备	outfit
轻蔑	slight
感到疼痛	hurt	pain
（夫妻）分居	separate
加边于	margin
收集	assemble	bundle	collect	gather	saving
销售	merchandise	sell
变得朦胧	film
使有纹理	vein
使变为	reduce	turn
使溶解	dissolve
成为弓形	arch
使杂乱	litter	pie
伸出(out的现在分词)	outing
终止（某事物）	quench
驾驶潜艇	submarine
供认	admit
凋谢	fade	pinch
使摆姿势	pose
查寻	seek
用带子围绕	zone
散布病毒	infect
根除	root
做东道主	host
绕轨道运行	orbit
使均衡	proportion
徘徊	hover	linger	range
声音等）映入眼帘	greet
图解	diagram
（液体）涌出	well
[建筑学]嵌上	tail
砸碎	shatter
和…有关	born
过冬	winter
（门等）装有蝶铰	hinge
陪伴同事	associate
怒喝	thunder
发明	contrive	originate	invent
筛选	bolt	rice
玷污	cloud	contaminate	pollute	spot	stain
厌恶	hate	resent	revolt	disgust	dislike
（使）结盟	ally
盛气凌人	bully
部署兵力	array
伪装	pretend	disguise
（与would或should连用表示客气）想	like
安	plant
擅长	excel
用脚尖触	toe
从…上除去细枝或枝条	trash
拉紧	strain	strain
赋予形体	body
误解	mistake	mistake	misunderstand
轻推	jog	jog
重读	stress	accent
抽签	ballot	lot
延续	run
削皮	skin
螺旋式的上升（或下降盘旋上升(或下降）	spiral
（使）联盟	ally
吐丝	spin
使轮廓鲜明	harden
使健壮	nourish
使发芽	sprout
中和	cancel
对待	treat	use
用力向某人刺去	thrust
使奔走	busy
确定（损害赔偿金、税款、罚款等）的金额	assess
以物易物	trade	truck
&给予	give
教养	cultivate	nourish
公开宣布	blaze
打雷	thunder
做模特儿	model
俚巴结	suck
暗中策划	plot
使负重担	tax
使劲	tug
不肯	refuse
运输	born	freight	paddle	transport
使充满	saturate	inform	invest
&（使）弯曲	curl
传球	pass
（使马）飞驰	gallop
汇编	compile
〈英〉付（款）	brass
刮去（皮上的）毛	grain
撤退	evacuate	retire	retreat	withdraw	withdraw
篡改(sophisticate的过去分词形式)	sophisticated
向…授课	lesson
强使	constrain
传讯	haul
分支形成	branch
使适应	condition	fashion	gear	season	accommodate
斜移	angle
处于边沿或边缘	verge
获利	profit	yield	advantage
使难理解	obscure
愿意做	mind
哄骗	trick
结婚	couple	wedding
转播	relay
注入	feed	pump
堆成禾束堆	shock
有销路	sell
卸掉负担（或负载）	discharge
在…设置船坞	dock
感到后悔	regret
消除	cure	drive	eliminate	satisfy	smooth	weed	wipe	dissolve
悬垂	hang
使发生相互作用	react
用树篱围起	hedge
进行偿还	refund
使饱含	litter
争论	argue	clash	contend	dispute
（向旅馆、饭店、戏院等）预约	book
使自由	free
积聚	gather
开始	begin	break	commence	enter	get	make	open	opening	originate	preface	initiate	institute
装腔作势说话	mouth
呕吐	heave	heave
投宿	room
upon)	attach
捕鸟	bird
怀疑	doubt	suspect	suspect	suspicion	wonder	dispute
贪婪地吃喝	punish
详尽阐述	elaborate
举枪	port
（使）聚集	focus
左转舵	port
破碎	crash	fracture	fragment
使打起精神	stir
友好	neighbor
使旨在	aim
陪伴…走	walk
（使）变冷	chill
（以…）瞄准	aim
（精神）突然崩溃	snap
大踏步走	stride
使成辐射状开裂	star
强使…通过	bull
拭	wipe
比拟	compare
增添	augment	lend
安排顺序	sequence
（用语言	paint
弥漫	permeate
拿	have	take	take
在…的边上	border
闹笑话	fool
很快接受	snatch
嵌合	table
拉	draw	draw	drawing	haul	pull	tow
经受	withstand
用无线电发送讯息	radio
使猛增	zoom
在…就位	man
忽然低下头（或弯下腰）	duck
迎合	cater	humor
拖	draw	drawing	haul	heave	tow
发现	detect	discover	find	scout	sight	sniff	spot	uncover	uncover	experience
让渡	alien
使变得温和或温柔	melt
爱	love
纵犬袭击（野兽）	bait
口彻底击败	massacre
给（饮料等）掺（少量的酒、药、毒药等）	lace
[航海学]停止工作	secure
使瘦	thin
使…变干	dry
打起精神	brace
悄悄溜走	skip
爬	scramble	scramble
应被放在	belong
把（权利、权威等）授予	lodge
[法]宣告无效	defeat
&分割	segment
（使）增至三倍	triple
（气体	escape
做特邀嘉宾	guest
追随	adhere	adhere
冒犯	offend
立案（控告某人）	book
嗡嗡叫	sing
把…搅成糊状（或奶油状）混合物	cream
激起运动	spark
（用手）打	buffet
贷（款）	lend
苦恼	anguish
适应不同情况（或环境）(to)	adapt
用尽	exhaust
（使）分开	segregate
浸透	saturate	soak
考查	test
使散布	sprinkle
在…处设井栏	curb
教育	educate	school	train	training
减幅	damp
得到或获准进行选择	option
申请（小孩）有特殊教育需要	statement
消除（疲劳）	cheat
住旅馆	inn
向下倾斜	descend
就…进行争论	dispute
定罪	damn
形成对照	contrast
使有凹陷	pit
作引体向上动作	chin
围攻	mob
猜中	guess
向…提供补给品	log
（使）移动	stir
[军]组编	embody
使起化学反应	react
疾病等）	contract
绕…运转	circle
玩弄	sport	toy	trifle
使前进	march
&轻声低语	mutter
称颂	proclaim
逐渐消散	melt
建立关系	connect
惯常地进行	practice	practice
轻擦	graze
停顿	hesitate	stall
认为（某人	consider
在铁路工作	railroad
突然倒下	fall
包	wrap
暴跌	dive
有指望	promise
漏出	leak
放映	project
（尤指以某种方式）注视	regard
忙得不可开交	swamp
以雕刻装饰	sculpture
擦痛	scratch
努力奋斗	strive
分裂	fragment	split	dissolve
走得极慢	lag
（以行动）做出反应	reply
分程传递	relay
（按新地址）转寄	forward
冒风险	gamble
度假	holiday	vacation
联系在一起	link
（使）反转	reverse
限制	block	bound	bound	chamber	condition	confine	constrain	control	hamper	limit	narrow	restrain	restrict
俯临	dominate
轻快摇摆地走	swing
（天）刚亮	dawn
应该（指道义上有责任）	ought
逼问	sweat
发送传递信号	broadcast
给…铺上甲板	deck
洒落	shower
预定（人或东西）作某种用途	mean
（为枪炮）装火药	prime
使准备好	prime
劝说	persuade	prevail
集中注意力	focus	accent
速度增加	accelerate
吃奶	nurse
生密枝	bush
坐火车旅行	rail
撒（粉）于	dust
加标签于	tag	ticket
与…斗争	combat
用电报通知	telegraph
贬黜	disgrace
发出火星	spark
脱（帽）	uncover
过时	date
用筛分选（卵石等）	riddle
归功于	credit
使出名	fame
拾坚果	nut
把…开入沟里	ditch
把…收集成卷	volume
用铁铸成	iron
[通信]报文	message
使镇定	calm
（给…）添加	inject
挤榨	crush
将…置于摇篮中	cradle
跌落	ebb	land
探出	nose
把…分隔开	space
获知	learn	understanding
以图案装饰	pattern
队伍单行行进时拉长或产生间隔	tail
吸（烟）	smoke
节制	moderate	pinch	refrain
锁住	catch
停止进行	abandon
使解体	resolve
拉长说	enlarge
失去控制	crack
尊崇	worship
上升	climb	hike	kite	mount	raise	rise	ascend
用汽车运送	motor
使变白色	white
给…戴上帽子	hat
突然涌出	start
腐朽	decay
用联合收割机收割	combine
〈俚〉枪击	plug
竖直放置	stand
抗拒	resist
（使）生锈	rust
参加[发起]运动	campaign
尤指降半音	flat
开出	render
使旋转	revolve	swing	whirl
朝…行进	head
悲哀地说	mourn
监测	track
四散	diffuse
编目录	catalog
使凌乱	disorder
表面起皮	peel
大量地给予	shower
分让	spare
使住满人	people
接合（折骨等）	knit
无畏于	dare
（把…）拍摄（成）电影[电视等]	film
赌输	game
告诉	hip	tell	tell
关押	pen	prison
&（使）摇摆	swing
（使）消瘦	waste
蒸发	evaporate
（翻阅旧记录、文件等以）搜寻事实等	rake
草拟	rough	sketch
熨烫	iron
（动作）衔接协调、流畅	fair
耙	fork
召集	call	rally
觉察	remark
勇敢面对	brave
（耍手腕）得逞	pull
使安心	reassure
[化]精馏	rectify
联想	associate
付款	pay
缓缓地变化或发展	grade
用…擦	rub
在…上覆盖金属板	plate
射门得分	kick
〈古〉压倒	oppress
使心绪不宁[烦恼	shake
拥有知识、理解力或信息	know
大发脾气	rage
配制	mix
搜集	gather	monitor
来到	strike
关心	care	concerning	respect	tend
向…表示恶意	spite
反射（光、热、声或影像）	reflect
留心	notice
叫来	call
使不适	turn
给与沉重的感觉	oppress
使（曝光等）超过时间	overtime
给（职员）下发学习（或工作）指令（通常与out连用）	staff
使牢固	firm	fix
用键盘进行操作	keyboard
耐洗	wash
弄砸	butcher
起反作用	react
旺盛生长	breed
掺麻醉药于	drug
节省	save	save	save	spare	spare
使感激	oblige
孵出	hatch
通过桥横跨	bridge
滚开	off
安心	rest
给…定价	price	value
[法律]确定（产权等）	quiet
归因于…	refer
制造	fabricate	make	manufacture	produce
常与…交往	frequent
使立定	halt
把…合成一体	consolidate
将…击向空中	sky
厌烦	sour	tire	weary
维持原状	continue
构成…的基础（或起因）	underlie	underlying
裁决	decide	find	rule	rule
把…掺在一起	blend
估计	calculate	estimate	figure	judge	reckon	reckon	age
兑现	cash
不愿	hesitate	refuse
变浓缩	condense
坐马车旅行	coach
踱步	pace
渐变	graduate	shadow
使急速上升	zoom
赶着…走	walk
使有脉络	vein
企图(for)	bid
回到（之前的位置）	resume
唱着使…	sing
归还	render	restore
来自	derive	descend	originate
使麻痹	numb	paralyze
变成青铜色	bronze
调查	examine	examine	probe	search	survey	investigate
抽打	lash	whip
伤脑筋	puzzle
主办宴会	host
面露喜色	beam
发挥（作用）	exercise
敬重	esteem
使闪光	flash
使不能正常活动	paralyze
使成螺旋形	spiral
压住	pin
摸出	fish
加固	reinforce
够…	reach
叫错名字	nickname
寻求生产商（或提供商）	source
滑脱	slip
内含	lie
&做梦	dream
与…通讯（或通话）	contact
休假	holiday
止付	stop
维护治安	police
作序	preface
扯	pull
扒	hook	pick	scratch
打	wipe
使获得座位（或席位）	seat
扔	pitch	pitch
会见	interview
&轻拍	pat
作无线电广播	radio
停止行动	cease
悄悄地走	glide	slope	steal
（用变音符号）改变	modify
防止	avert	combat	prohibit
计入	number	include
用面纱遮盖	veil
喜欢做	like
冒险前进	venture
使担负	load
（从容器等）汲取（液体）	tap
微微摇摆	balance
说出来源	locate
预告	announce	predict	warn
乘出租车	cab	taxi
使（机舱等）增压	pressure
[生化]确定…的顺序	sequence
把事情弄糟	mess
问候(greet的现在分词)	greeting
热爱	love	worship
把…记录在案	minute
粉碎	mill	shatter
把…托付给	commit
（感到不能）对付	face
把…付印	print
论证	demonstrate
发布	release	issue
（使）镇定	calm
使（鸟）飞起	rise
台球、普尔和斯诺克击（球）入袋	pot
把…放在适当位置	position
成为一体	integrate
使垮台	overturn
占优势	prevail
使相配	match
（水禽）游泳	sail
抛出	shot
讨好	butter	please
猛推	bull	put	shove	thrust
作（茧）	spin
[物]阻尼	damp
想法、情感或氛围盛行	reign
猛掷	dash	hurl
近似	border
引上钩	hook
使恐慌	frighten	panic
&抓住	seize
转乘	transfer
手工制作	craft
随手射击	pot
（明知不好办而）交谈	face
行使	use
夸赞	applaud
爱慕	love	adore	adore	worship	worship
给…沏茶	tea
沉浸在（工作或学习中）	soak
口解雇	fire
附带说明	add
提供资金偿付（债款等）的本息	fund
编排	weave
剁碎	chop
表现卓著	star
为…调音	tune
用齿轮连接	gear
加	cast
让与	render	transfer
向…献殷勤	court
使对某人有利	avail
处于…状态	go	lie
抗争	oppose
使…有粘性	gum
美/口拖	snake
劈	chop	chop
指向	point
试验	essay	pilot
（在马上）拿枪扎	tilt
足够维持（尤指某段时间）	last
熬住	persevere
临时安顿	camp
摇摆	sway	wave
（使）振奋	waken
提供(+for)	provide
停飞	ground
给…上粪（施肥）	soil
（用笔等）画	stroke
用皮革包盖	leather
大胆	dare
“rend”的过去式和过去分词	rent
用青草饲料喂养（牲口）	soil
踏	foot	step	tramp
把…打起泡沫	whip
使焦虑	rack	dismay	exercise
撞击出刺耳的响声	clash
给…梳妆	toilet
低头	bow
用潜艇攻击	submarine
评价	estimate	evaluate	evaluate	judge	place	value
射出（子弹、箭等）	loose
&钻（孔）	drill
踢	boot	kick
把（电线）接地	earth
捉弄	rag
参加宴会	banquet	banquet	feast
安慰	comfort	console	sympathize
踱	pace
使中邪	magic
侦查	case	detect
提交	submit
买到	obtain
艰难前行	bore
包出	farm
搏斗	struggle
追寻	chase	chase
附加加重值于	weight
使有缺陷	flaw
蒙混	shift
缓慢前进	drag
互搭	overlap
[英国英语][狩猎]发现猎物	find
挥手指引	wave
破晓	break	dawn
扭曲身体	twist
离间	alien
不断侵扰	hound
大举包围	mob
使堵塞	jam
变稳固	firm
筹备	prepare
描绘	depict	describe	paint	picture	portray
得出结论	conclude
（票据等）到期	mature
用带做记号	belt
赞成或同意	okay
产生作用	stick
缓慢移动	inch
授予（某人）勋章	decorate
创始	begin	originate	initiate
咨询	consult
哀悼	moan	mourn	pine	regret	weep
找到	find	found
翻腾	tumble
使…安静	quiet
反照	reflect
灌木般丛生	bush
使更健壮	tone
激发…的积极性	motivate
[体]用高尔夫球棒尖端击	toe
揭示	uncover
趟水	paddle
断绝关系	separate
使服麻醉药	drug	drug
骗取	shark	short	sponge
野餐式地用餐	picnic
肩起	shoulder
设立	constitute
付定金保留	retain
合计金额	consolidate
（鼓）咚咚地响	beat
架住	ward
平淡无趣地写	prose
归拢	bundle
（在某银行）开账户	bank
变硬或更硬	harden
使遇难	wreck	wreck
生蛋	lay
使成泡沫状物	foam
认为…是	attribute
依赖于	trust
戴着	wear
使劲一推	slam
成群地袭击	gang
（机车等）喷气	pant
（不用多少动力）快速平稳地移动	coast
打折	discount
鄙视地说	sniff
动脚尖	toe	toe
省略	omit
接吻	kiss	kiss	lip
晾晒	air
拼写(spell的现在分词)	spelling
挖战壕	trench
紧握	clutch	fasten	fist	clasp
增进健康	gain
用降落伞投送	parachute
刺激	motivate	needle	stimulate	sting	excite	irritate
倾向（于）	tend
歼灭（敌人）	destroy
[植]通过压条法而生根	layer
源于	derive
协调一致行动	concert
酬报	repay
征募新兵	recruit
给…上脚镣手铐	iron
央求	pray
遛	walk
（舞蹈者的双脚）轻快地移动	twinkle
接合	seam
让吃饱	stuff
剪掉	clip
当船员	crew	ship
表达意见	comment
开展	unfold
（使）振动[颤动]	vibrate
抹黄油于…上	butter
使联合	unify
使紧密联系	affiliate
飞奔	tear	whirl
使成蓝色	blue
（按订单）供应	fill
使悄悄转动	slide
随意翻阅	browse
使（植物）枯萎	pinch
背叛	betray	defect	revolt
使有意于	dispose
涂底漆	prime
求助于或诉诸某事物	resort
忍耐	endure	endure	refrain	resist	swallow
用功	plug
迫使	compel	exact	necessitate	pressure	whip
侵蚀…的基础	undermine
聊天	chat	chin
举枪瞄准	present
繁盛	prosper
道歉	apologise
使振奋	revive	rouse
承认	concede	confess	face	grant	own	own	recognize	recognize	tolerate	accept	accept	acknowledge	admit	admit	affirm	agree	allow
有斜度	slope
使投降	surrender
加盖于	case
逆向移动	counter
垫牌	discard
避开	avoid	escape	evade	skirt	ward
从属	attach
（用垫子）使柔和	cushion
撒	sprinkle	sprinkle
扇动	fan
取得资格（与as连用）	graduate
露出	shine
撞	strike
迅速处理	hurry
调解	compose	accommodate	intermediate
做裁缝	tailor
诱惑	attract	charm
偶然发生	chance	fortune
分成等级	graduate
测算	reckon
忽略	forget	neglect	overlook
看错	mistake
使厌恶	repel
俯瞰	survey
碎裂	chip	fragment
代用	substitute
泛滥	overflow	pour	swarm
邮寄	mail	post
后果	result
必须	entail	have	need
使受限制	trap
安静	still
变跛	lame
廉价出售	remainder
不理会	disregard
使留下伤痕	scar
大声喊出	bark	roar
登上王座	throne
匆忙	haste
委任	commission
逃脱	cheat	escape	evade	evade
对不起	forgive
感到害怕	fear	scare
蜿蜒	sweep	twist	wind
锻炼（身体某部位）	exercise
啪啪作响	snap
[非正式]发怒	steam
（山丘等）隆起	heave
盘存	inventory
使下垂	sink
向扔石块	stone
不批准	veto
（火）猛然的扩大	mushroom
犯规	cheat	offend
由于航行时太靠近风而使（帆）颤动	shiver
遮蔽	cover	hide	shade
…不堪	overcome
去野餐	picnic
用沥青涂	pitch
使硬化	harden
投稿（给杂志等）	contribute
（使）凸出	swell
把…归于	attribute	thank
以短程往复方式运送（货物等）	shuttle
（因事故、年老、死亡等）损失	lose
夺取或抓住	grab
用楔子楔牢	wedge
使搭伙	board
感觉	feel	feel	feeling
使麻木	numb	perish
偶然遇到	happen
使疲劳	fatigue
（工作等）进行	run
装腔作势地说	mouth
用信号表示	sign
对…有用	serve
（使）仓促行事	rush
发射（声音等）	echo
使挥发	evaporate
操纵	govern	guide	handle	man	maneuver	manipulate	steer
渐渐变大	wax
&唱	sing
〈古〉照耀	enlighten
把…专用（于）	devote
使用混凝土	concrete
把黑油彩抹在（演员）脸上	black
启示	suggest
俚（迅速）离开	split
（使）疲劳(tire的过去式和过去分词)	tired
开炮	cannon
救命	spare
猛挤	bull
画轮廓	outline
使…厌烦	tire
轻抚	stroke
揭开	bare
征税	levy	toll	impose
打闪	lightning
签名（在…上）	ink
[地质学]产生断层	fault
为…提供证据	approve
看见(see的过去式)	saw
对…进行突然袭击	raid
形成日（或月）食	eclipse
蛊惑	fascinate
指责	blame	charge	damn	rag	tongue	accuse
（委员会等）监督	police
拥有	own	possess
引起疼痛	pain
用意志力驱使	willing
射中	shot
威胁	cow	menace	terrify	threaten	intimidate
动武	assault
合拢（伞	shut
使容易	facilitate
（船舶等）复正	right
（小鸟等）唧唧地叫	peep
使惊惧	awe
写印刷体字母	letter
用刨刨平	plane
传真	fax
组合	assemble
使紧密相联	knit
使…模糊不清	obscure
安排	bill	conduct	grade	pave	schedule	setting	settle	structure	dispose
向上推起	boost
使按顺序排列	sequence
（使）停止工作	stop
装防护物	shoe
备有	stock
依…而转移	hinge
试图	attempt	endeavor	try
给…装上铃	bell
使成形	bend	shape
炮轰	cannon	shell
完全填满	heap
版面）	pie
讲授	instruct
主宰	possess
作调查	investigate
转向东方	orient
递眼色（表示友好或高兴等）	wink
折叠	collapse	fold	lap	lap
禁闭	confine
细想某事	dwell
附着	attach	fasten	adhere
使稳固	anchor
俯首	bow
荡桨	paddle
积存	fund
（下国际象棋时）用车护（王）	castle
报废	scrap
[橄榄球]擒住并摔倒（一名对方球员）	tackle
使植物繁盛	bloom
电报：用电报机发送的信息	telegram
顾及	consult
加商标于	brand
躺	lie
使调动	transfer
成群地迁徙或飞行	flight
捕鼠	mouse	rat
度周末	weekend
用船装运	boat
通讯	communicate
打败	beat	tank	triumph
委屈	wrong
（高尔夫球等）进洞	hole
与…交往	mingle
留意	regard
吸引异性	pull
悄悄地做	steal
托付	commend	recommend
达到平稳状态	plateau
更衣	change
抵达	fetch
邻近	adjoin
放置	deposit	lay	pile	place	set
志愿提供	volunteer
使相称	match	proportion
任大学导师	tutor
（使）结冰	ice
[神]启示	reveal
在…搽粉	powder
[法]不经宣誓而庄严宣布	affirm
天赋权力（或才能等）	gift
担任主角	headline
表现	behave	embody	perform	represent	act
废弃	junk	obsolete	scrap	trash
旋紧	screw
准备	brace	fix	prepare
亏本出售	sacrifice
[法律]（原告对被告）答辩	reply
审理	hear
使起褶：使（织物）起褶	bunch
封闭	shut
使艺术化[仅用于artup短语中]	art
与…共存	accompany
表明	argue	communicate	designate	evidence	manifest	point	proclaim	say	say	show	imply	indicate
减价出售	discount
把…关入牢中	cage
合适	suit
插	plant
鼓胀	bag
为…描眉	eyebrow
合住	room
有缺口	gap
使出血	bleed	blood
衰减	degenerate
揍	wipe
破坏	breach	crab	destroy	kill	ruin	undermine	waste	wreck	disrupt
被加热	warm
合作	collaborate	cooperate	team
发出刺耳的声音	jar	scrape
强行带走	cart
用发动机发动	power
走在…前面	preceding
使（两人或两事物）紧密结合	twin
成环形	ring
警告	caution	warn	alarm
使…成排	row
流干	drain
拉（车）	wheel
行驶	run
想象	fancy	picture	suppose	vision
肢解	limb
肯定	affirm
讲述	pronounce	relate	spin	tell
为…装上接头	joint
（使…）成双	pair
炎热	bake
长成	blossom	mature
集中	centre	concentrate	fasten
交还	restore
担心	care	dread	worry
（向更高方向）增进	progress
分解	analyse	resolve	dissolve
游泳	bathe	swim
整顿	sort
测量深浅	bottom
受欢迎	sell
启程	start
采	pick
折中解决	compromise
背诵（台词等）	study
担忧	tremble
感受	experience
挑逗	tease
使污秽	foul
汲取	draw	squeeze
用鱼叉捉	spear
志愿	volunteer
进行易货贸易	exchange
[英][俚]大发脾气	create
仿古制作	antique
选派	assign	detail
系上	tie
击败	defeat	floor	hammer	worst
使恢复	refresh	renew	restore	revive
逐渐增加	gather
循环出现	revolve
扭转	screw	wrench
[美国英语][教育学]主修(in)	major
刷	brush	brush
轮替	spell
沉淀	deposit
转舵（向左）	port
刺	dig	knife	needle	poke	prick	spear	stab	stab	sting
刻	character	chip
腾出（房子等）	evacuate
刮	scrape	scrape	scratch
排定	schedule
吐出	sick	spit
划	run
使协调	coordinate
自信地期待	trust
构成释义	define
大吃大喝	feast
供职	serve
分	parcel	divide
切	carve
启动	open	opening	roll
秘密潜入	penetrate
熄灭（火）	extinguish
使…浮上水面	rise
持有	conceive	hug
溜达	stroll
使惊吓	startle	terrify
用公式表示	formulate
去壳	shell
用带子捆起来	tape
通过表针控制	dial
使紧密结合	wedding	weld
使大为吃惊	astonish	amaze
出场	appear
使吃重	weigh
〈美俚〉得到	spear
以…供奉	dedicate
合并	consolidate	consolidate	unite	absorb	incorporate	integrate
用蛋烹调	egg
忍受	bear	brook	pocket	stand	submit	suffer	sustain	swallow	tolerate	abide	absorb
筹集	raise
投篮	shoot
供应帽子	hat
尖啸而过	zip
恢复健康的状态	heal
猛推或用力向上举	horse
许诺	pledge	promise	promise
称赞（某人/自己）	pat
瞪着看	outlook
切断	section	shear
经过转变	convert
把…按目录分类	catalog
（人）靠欺诈为生	prey
使理解或接受	educate
关系	regard
作罢	retreat
发声	sound
光顾	frequent
服役	serve
装货	load
实验	try
使更紧密	condense
给…装铁具	iron
为…谱曲	compose
评定	assess	reckon
朗读	read
把某事通知某人	acquaint
酬谢	reward
不合	clash
明智地使用（金钱、时间、信息等）	manage
不同	differ	vary
动怒	rage
松土	dig
发信号	signal
补救	remedy
（使）行动	stir
给…盖盖子	lid
看懂	reading
（心）怦怦跳	knock
喝（酒）(drink的过去分词)	drunk
使发炎	irritate
被加工处理	cure
摘要	excerpt
夸张	puff
使经营	busy
使成堆	couch
试图抓住	clutch
使吃惊	stagger
渐渐不明	faint
英澳·非正把…说得一钱不值	rubbish
暂时遮掩一下	patch
（狗）沿臭迹追逐（猎物）	road
&（使某物）变黄或发黄	yellow
指令	command
停止	cease	cease	drop	halt	quit	quit	rest	stay	stop
使位于	situated
对…估计不足	underestimate
租用	hire	tenant
维持	maintain	support	sustain	uphold
寻欢作乐	pleasure
绕过	round
竭力	endeavor
使（飞机）在海上紧急降落	ditch
学习(learn的现在分词)	learning
使成为	establish	make
对…不忠	betray
在…下面画线	underline
发送	forward
以协议（或契约）约束	article
掷还（球）	field
把…灌制唱片	wax
看守	guard	watch	watch
（齿轮	bite
（以水）冲刷	flush
含糊地说	mutter
调整（镜头	focus
称做	entitle
扩展	build	enlarge	expand	grow
喘气	blow	gasp	pant	pants
彻底失败	fold
对…进行游说	lobby
使吸收	assimilate
使跌倒	tumble
[军事]传（或通）令嘉奖	cite
（对…）动手术	operate
步行穿过…	tramp
使转动	rotate	turn
有放大能力	magnify
拉选票	ballot
以代理商（或管家等）的身份行事	factor
自花授精	self
使…上船或飞机	embark
担负	shoulder
给…穿衣	dress	dress	toilet	invest
充满回声	echo
使惊恐	fright	frighten	scare	alarm
为电影（或戏剧等）写剧本	script
测量（大小	measure
点…的数目	count
缝	stitch
给…用药	medicine
编	weave
诈骗	cheat	screw	shark	stiff
打烙印于	brand
[证券]（证券、股票等）价格上涨	bull
与…有关	bear	affiliate
仔细查看	explore
使变黑	black
欺诈	deceive
闪现	occur
扼止	choke
涌上	well
驱使	drive	propel
收买	buy
显露出	show
向上击	spoon
使…冒风险（或面临危险）	risk
把…放在次要地位	postpone
担任检察官	prosecute
用石头铺	stone
使萎缩	winter
不怕	brave
为…增加趣味	salt
喝彩	root
作口译	interpret
挟住	shut
转变	change	switch
取消	cancel	pull	recall	scrap	undo	void	abolish
作客	guest	visit
（尤指为科学目的的）观察	observe
在浅锅中烹调（食物）	pan
保证	engage	guarantee	pledge	plight	tell	undertake	warrant	insure
搔	scrape
使靠近	close
住在岛屿上	isle
搓	twist
纵火烧（建筑物或汽车）	torch
献祭	sacrifice	sacrifice
为…做衣服	tailor
删掉	omit
使粘附	adhere
教书	teach
把任务交给	mission
交配	couple	pair
脱口说出	bolt
泄露	betray	reveal
战胜（对手）	win
通晓	understanding
拍发电报	cable
（使）某物变得阴沉暗淡	cloud
判定	award	determine	doom	rule	verify
把观点强加于他人	intrude
简略地触及	glance
枯萎：使枯萎	blast
熟知	understanding
（意思上）指向	point
崇拜	god	praise	adore	adore	worship
用药物治疗	medicine
以管输送	pipe
使开始作用	activate
围住	case
尺寸等）	measure
解放	liberate
计算在内	figure
视察	inspect
粉饰	color
牵涉	involve
捻	twist
飞升到	soar
填写（表格）	complete
（用拉索等）固定	guy
使处于困境	tree
&问	ask
当播音员	announce
使成比例	proportion
意欲	intend
避免	avert	avoid	beat	hedge	help	saving
非正为…提供最新情况（消息等）	clue
使手足无措	bewilder
（使）旋绕	curl
使有机化	organize
用棍棒打	club
使…有力量	power
类似(correspond的ing形式)	corresponding
捏	pinch	squeeze
（使）具有资格	qualify
想望	desire
下落	sink
捅	poke
使停止[结束	kill
使…前后倒置	invert
虚度光阴	lounge
打电话给	call	ring
比…漂亮	outlook
拍打	paddle
侥幸成功	luck
拍手	clap	clap
快速移动	jump
（古语）敬畏	dread
卷走	whirl
用卡车装运	truck
核算（盈亏）	adjust
鼓舞	elevate	encourage	lift	rouse	spark	spirit	stimulate	inspire
造成…结果	issue
使延期	postpone
用目光压倒	outlook
把…放在钟形罩内	bell
使掠过	skim
将塞条嵌进（伤口）	tent
改革	reform
使…有联系	connect	relate
与…保持距离	distance
猛撞	bang	dash
梦见	dream	vision
成为最显著的	reign
使…的失败	doom
抚育	cherish
由专家审读（书籍等）	expert
&与人约会	date
以微笑表示	smile
风行	rage
抄写	copy	copy
注释	comment
波浪等）博斗	buffet
植芽接	bud
提出理由	argue
创作	create	originate	produce
变狭窄	neck
快跑	course
隐藏	bury	conceal	hide	lock	obscure	pocket	shut
被列为某类（或某级）	class
跟着人（或物）去（或来）	follow
厉声说出	bark
用缭绳调节（或固定）	sheet
把…烧成炭	coal
总共收入	gross
使下沉	sink	wreck
弄清	ascertain
进行挑选	choose
促成	favor
开（某人的）玩笑	rib
编辑	compile	edit
使成直角	square
施巫术	witch
创利润	profit
录音）	edit
擦破	graze
陈述	state
预示凶兆	threaten
浓缩	concentrate	concentrate	condense
记住	learn	learn	retain
冲	dash
使关心	concern
珍惜	prize	treasure
剪裁	tailor
使外倾	flare
榨取	milk	milk	rack	shark	squeeze
给人铺床	bed
写	pen	write
适合	apply	become	cater	serve	sort
打喷嚏	sneeze
声明反对	protest
标记	stamp
沉浸	submerge
给…以席位	bench
观察和辨认鸟	bird
（太阳等）徐徐上升	climb
把…做成三明治	sandwich
被撞碎	split
对比	contrast
把地毯铺在…上	carpet
（使）偏航	sheer
原料来源	source
治理（国家）	administer
坚持	assert	cling	persevere	persist	stay	adhere	adhere	insist
与…相比	parallel
使满足或足够	satisfy
围绕	margin	sphere	surround	involve
在…出现	inhabit
给…打蜡	wax
成为王后或其他大于卒的子	promote
严重削弱	cripple
富集	concentrate
提供	bring	offer	provide	provided	serve	subject	afford	furnish
嚼舌头	talk
吃草	browse	pasture
干掉	waste
用印刷体写	print
弯弯曲曲地走路	zigzag
勉励	strengthen
[美国俚语、口语]狂欢作乐	ball
探求	search
公然反抗	defy
登山	climb
遗失	lose
纠结	foul	herd	lock
使用空头支票	kite
扎营	stage
使佩带像章（或徽章、标记）	badge
捣碎	pound	stamp
使稀疏	thin
突然转变方向	wheel
反射	mirror	reflect	reflect
害臊	blush
（使）缩水	shrink
增大	make	increase
勾结	collaborate
俯冲	plunge
问问题	enquire
衰落（成）	slide
拖曳：让…拖或飘扬在后面	trail
呻吟着说	groan
为…配备工作人员	staff
低落	recede
喜爱	love
消亡	vanish
（心脏）跳动	pulse
交尾	pair
包住	include
增多	increase
求…的值（或数）	evaluate
举行或参加（系列）会议	conference
紧随	dog
强行登（船）	board
用砖建造、砌或铺	brick
笨重地行进	lumber
为特定用途而打算	intend
致敬	bid	greet	greeting	hail	salute
用摘抄等方法编辑	quilt
有…的迹象	scent
用抽水机汲水	pump
授予权利或方法	enable
审核	process
题词	subscribe
造园	garden
抓紧或抱住	cling
确切地阐述	formulate
提请考虑	float
隐退	peer
使起皱纹	wrinkle
由…代理	agent
取得专利权	patent
饮宴	banquet
引述	quote	quote
倾倒	dump
对（某事物）作最低估计	minimize
供给…早餐	breakfast
加强	augment	consolidate	enforce	enhance	mend	reinforce	strengthen	underline
认为	believe	consider	count	deem	deem	esteem	feel	feel	figure	guess	hope	judge	presume	rate	reckon	suppose	thought	view	account
提供专业咨询	counsel
爬行	crawl	creep
给…加燃料	fuel
激（某人做某事）	dare
使恼怒	annoy
摇匀	toss
洗盆浴	tub
把（短期借款）转为有固定利息的长期借款	fund
引进	inlet
找一找	seek
吹奏管乐器	pipe
有成就	star
糟蹋	murder	rag	spoil
固定系牢	cable
（使）破	break
诠释	interpret
中伤	assassinate
用机器制造	machine
降雪	snow
搭伙	board
（人与命运	buffet
〈美〉有倾向性	tilt
弥补（缺陷、损失等）	supply
有或起作用	function
流	flow	stream
紧拥	clasp
（使）进行	progress
穿（衣）(clothe的第三人称单数)	clothes
[体育]击球	stroke
令人陶醉	charm
浸	bathe	dip	swim
面露	wear
猜对	guess
确认	recognize	admit
以誓言约束	pledge
留住	detain
作出握住或抢夺的动作	snatch
用鼻子触	nose
调节眼球的晶状体（使其变得适应不同距离的物体）	accommodate
喊叫着说出	scream
度过	live	pass	spend
使干净	clear
均摊	share
（使）产生分歧	divide
摇头	shake
监禁	chain	gaol	prison	restrain
<俚>抚摸身体	grope
钻孔	bore
用桩区分	stake
重复投票	repeat
猛开车	bucket
使蒙受（耻辱）	clothe
用手掌抚摩	palm
散发	evolve	distribute
传染：扩散	communicate
吸引（注意）	arrest	absorb
用船桨推动（船只）	paddle
使过得快活	enjoy	enjoy
快速转移	skip
〈口〉通过擦拭使…变得有光泽或光亮	shine
给…穿上上衣[外套]	coat
违反	breach	violate	outrage
给与…权利	entitle
打褶	bunch
紧挤在一起	pack
使干燥（染过的物品）	master
过放荡生活	hell
想法、意见等相同	coincide
使（飞机接合部）平滑	fair
斟	pour
集合	assemble	collect	congress	group	rally	rally
弄错	blunder	mistake	mistake	stumble
打电话（给某人）	phone
跌跌撞撞地走	stumble
用带捆扎	strap
有益	profit
发出警告	warn
涌出	flood	pour	pour	pump	spill	well
与…作战	battle
[生物学]使进化	develop
吃午餐	lunch
代理	represent
走到	reach
（使）下决心	determine
有…野心	ambition
吃得过量	pig
投资于	embark
增补	supplement
使调整或者成为一条直线	orient
维持（有利的）平均价格	average
使泄气	damp
适用	apply	apply
花钱	spend
（国家独立后在经济、社会、政治等方面）发展	develop
构想出	formulate
激增	balloon	explode
举…为例	instance
使回旋	whirl
说（问候话）	bid
（尤指）酗酒	drink	drunk
担保获得[避免]	ensure
起凹点	pit
堆成堆	stack
公然反对	beard
哭得使…	sob
装好（船具）	ship
&对…具有重要影响	condition
祝贺	congratulate
轻轻拍打	lick
（使）直立	stand
取代	displace
猛力打击	slam
吃早餐	breakfast
挑选	choose	elect	elect	nominate	opt	pack	pick	select	single	sort
（牛）哞哞叫	low
对…甜言蜜语	honey
投稿	contribute
给…裹上（糖衣或类糖物）	sugar
寻求来源	source
英给…保险	assure
简述	capsule	sketch
割爱	spare
联手	unite
使巩固	confirm
倾销	dump	unload
丢下	dump	hurl
乘（…的）飞机	fly
宠爱	caress	pet
当政	reign
从事制造	manufacture
忙乱	fuss
起主要作用	feature
快速行进	post	power
用肩顶…	shoulder
分担	split
握手	shake
聚成一组	bunch
周游	circuit
大声说出或宣告	trumpet
（一对动物或鸟）交配	mate
（使）迅速转身	wheel
用力放置	slap
安顿	install
把…（系统地）分类	arrange
改写	adapt
筑铁路	railroad
[医]〈旧	anger
渗出水汽	weep
断定	deem	judge	reckon
使负担或压迫	weight
偷偷地拾起	palm
放逐	exile
滑雪	ski
费力搬运	cart
成片流动	sheet
蛇行	snake
&吞	swallow
溶解	melt	melt	dissolve
使暴露	disclose	expose
觉悟	awake
贬低	trash
变得完美	polish
休息	rest
预付	advance
巡航	cruise	cruise
犯伪造罪	forge
削除	axe
同情	sympathize
敷（药）	apply
虐待	devil	oppress	abuse	outrage
（给…）洗澡	bath
被想到	dawn
在生活中得到享受	live
把（草）制成干草	hay
站立	stand	stand
使和谐	tune
秘密事先运作	stack
使专心于	involve
赌博	bet	gamble	gamble	play
曲折地前进	zigzag
（使）结婚(marry的过去式)	married
使显露	disclose
使有胡须（颌毛	beard
除去	strip	clear
失色	pale
治愈	cure
冻伤	freeze
牢牢抓住	hook
骑自行车的人上下蹬踏板	pump
提供住宿	sleep
共同出资	club
给…加油	fuel	oil
耳语	whisper
搬家	move
求…的立方	cube
（使）冷静	cool	sober
模仿	borrow	copy	model	pattern	simulate
用船运输	boat
标示记号	highlight
掩蔽	bury	curtain	shelter
[电子学]电波传送	gate
辗	roll
匆匆拿走	grab
当…的首领	boss
给…开账单	bill
解散（队伍等）	dismiss
向…收通行费	toll
改良	amend	improve
练习击剑	fence
移居	remove	transplant
翻来覆去	tumble
使躺卧	couch
透入	pierce
向下延伸	descend
亲自携带	born
用上浆纱布装（书脊）	super
用陶罐或坛子煮	jug
赶上	catch	overtake
钓鱼	fish	fish	fish
乱丢杂物	litter
变得苍白	appal	pale
（鸟或飞机）滑翔	glide
使滑行	glide	taxi
使生裂缝	flaw
（为工艺品、装潢项目等）设计	design
使相信	convince	persuade
冷却	cool
把…引入内室密谈	closet
擅自行动	presume
退休	retire	retire
被改变	convert
松开（离合器等）以开动	trip
渴望	aspire	desire	die	gasp	hunger	long	pant	pine	pine	thirst	weary	wish	ache
纺纱	spin
捏造	fabricate	forge	manufacture
坚持做	soldier
好像	seem	sound
静止	rest
向外张开	flare
拿…冒险	venture
疾驰	fleet
位于(lie的过去式)	lay
不尊重	mock
轻易打败（对方）	hammer
调准瞄准器	sight
成群飞离蜂巢	swarm
起泡沫	foam
署名	subscribe
使用钥匙	key
重视	treasure	value
抓走	cart
挖苦	quiz	roast
驾车到处跑	tool
切割	knife
睡	sleep
流露出	telegraph
诅咒	curse	damn	damn
恢复健康（体力、能力等）	recover
揭疮疤	rank
减轻（声音）	mute
为…测定时间	minute
辱骂	signify	abuse	insult
被击碎	smash
贸易	trade
受…的束缚	hedge
漫射	diffuse
渐渐消失在某物中	merge
放任	permit
给…免去	excuse
管辖	rule
以…为号召物	feature
言不由衷地说	mouth
申斥	rate	reproach
犯过失	slip
跳跃	dance	jump
link-朦胧出现	loom
使起泡沫	foam
表示愿意	offer
捕食	prey
读懂	read
猜疑（是）	suspect
湿透	soak
讲道	preach
滴下	distill
追上	overtake
导演	direct
（日、月等）落山	set
消耗	consume	spend
一瘸一拐地走	limp
打击	strike
存在于	dwell
给…以深刻印象	impress
尊敬	esteem	honor	regard	respect
随手扔	shove
使…疲惫	tire
位于	lie	locate	rank
镶钻石于	diamond
测定…的时间	time
自称	pretend
诱导	motivate
监看	track
给…薪水	salary
做研究	research
[体]违反规则的	foul
退票	bounce
滑	slip
使生效	implement
陈化	age
使…结合	league
攫取	grab
猛增	jump	soar
使变苦	bitter
打搅	annoy	upset
满	brim
使烦忧	fuss
详述	amplify	amplify	detail	enlarge	recite	specify	discuss	expand
耽搁	delay	detain
（猫等）舔净（自身）	wash
给…装衬垫	pad
丰富	abound
（在…中）任职	sit
阻塞	block	dam	obstruct	obstruct
刷白	white
救球	save
做主人	host
标明	reading	record
宣布	announce	declare	post	pronounce	sound	testify	intimate
赔偿	compensate
使受（影响等）	exert
（使）变暗淡	dim
用垫料填塞后缝拢	quilt
使遭受危险	hazard
兴奋	bubble
在…轨道上运行	orbit
压垮	overwhelm
喘着气说	pant	pants
（坚定地向某地）前进	march
充满热情	fire
把…画成纤细画	miniature
拉锯	saw
[生]变异	vary
渗透	filter	permeate
认为(feel的现在分词)	feeling
移居国外	emigrate
给…加佐料	relish
侵入	intrude	invade
集中（光束于）	focus
吠叫	bark
想知道	wonder
拿起	up
掸（一掸）	dust
修建	construct
把…送回家	home
推广	generalize	generalize	extend
驻扎军队	position
n.机动	maneuver
失信	stiff
追捕	chase	hunt	pursue
抗议	complain	protest	protest
涌入	invade
收割（庄稼）	harvest
出名	star
先于	precede	preceding
用黏土处理	clay
使（文体）简洁	compact
不期而遇	encounter
动手术	operate
站开	off
存款	bank
骄傲	glory	pride
吹小号	trumpet
兼有	combine
回报或回复	respond
用药麻醉	drug
（在比赛等中）输	trail
招待	guest	serve	tend
为…制订计划	blueprint
自己谋生	shift
接受培训	train
投弹于	bomb
剃毛	shave
使狂喜	entrance
作为…的例子	example
属于…等级	grade
捐赠（款项）	contribute
征集	levy
调准（机械的）速度	time
退还	refund
“wind”的过去式和过去分词	wound
俚背叛	rat
利用（机会）	improve
船等）上装货	burden
敲诈	blackmail	bleed
把…分给(to)	portion
退隐	retire
血污	bloody
捐赠	endow	subscribe
露顶	crown
使敬畏	awe
除草	weed
融化	dissolve
服用药丸	pill
与…战斗	combat
打碎	smash
预期	expect
呼唤	call
看出	discern
占主导地位	reign
尽心竭力地做	elaborate
使凝固	concrete
交易	deal	trade	traffic
成索状或绳状	rope
获得知识	discover
抢夺	grab	rob	scramble	snatch
使消遣	amuse
开列…的清单	inventory
（为…）工作	serve
被吊死	hang
达到最大值	peak
收款	collect
拼命叫喊	scream
（使）发育	develop
处理	manipulate	process	treat	unload	address	dispose
[法]转归	lapse
蹙额	frown
扭动	twist
[俚语]涂鸦	bomb
放牧	grass	herd	pasture	shepherd
使（士兵）驻扎	quarter
以专家身份研究（或检查）	expert
洒满	swim
定…的罪	convict
谨慎花钱	budget
杀菌釜	retort
给…供膳	mess
鼓掌	applaud	clap	clap
将（狐）赶出	uncover
使成珠状	pearl
按能力分班（或分组）	stream	stream
在…中具有最重要（或明显）的特色	dominate
重现	recur	reproduce
变得粗心大意	nod
流血	bleed
招收	enroll
（向…）弯腰	bow
描画	depict	portray
把…制成药丸	pill
住在…	occupy
使交替	alternate
流行	obtain	obtain	prevail	rage
嗅出	nose
文饰	polish
代表	represent	represent
遵从	comply
（使）聚集成团	pack
喝干	drain
预备（饭菜）	prepare
操心	bother
迷住	possess
教课	lesson
找矿	prospect
清晰地发（音）	articulate
记录	chart	monitor	note	document
献身	dedicate
（使）蒙上薄雾	mist
高飞越过	soar
在…造林	forest
惊奇	wonder
屈身	bend	lean
将…送往	put
有坏处	hurt
颠簸	bump
吐口水	spit
疏忽	forget	nap	neglect
讲…的故事	story
树立	setting
睡觉	sleep	sleep
象鹰一样俯冲攻击	hawk
使…向远方延伸	remote
施加压力	pressure	squeeze
处罚	discipline	punish
配合	cooperate
平局	tie
说服	argue	convince	get	persuade	prevail	push	win
（尤指跟在他人后面）疲惫地走	trail
使消息灵通	hip
创立（新思想）	father
（指消息	leak
遗漏	neglect	omit
给…调味	flavor
耗费（时间等）	take
清点	count
以…覆盖于	paste
选举	elect	vote
极想	long
使服从	submit	subordinate
骑上	mount
（涂蜡等）打光滑	polish
放	put
散播	disperse
使定居	settle
忍辱	stoop
[化]用放射性元素使（元素或原子等）示踪	label
使眼色	wink	wink
和谐	time
跳落	land
夸耀	sport
不请自来	horn
按大小排列	size
吸气	inhale
迂回	wind
再生效力	revive
使（面颊）发红	rose
[统]使加权	weight
把…装进贮藏库	bin
被毁灭	ruin
悲伤	grieve
逃避	escape	evade	evade	flee
掉下	fall	fell
约莫	say
匣]中	box
发生裂痕	seam
留边	margin
反抗权威	rebel
（用石子	shy
装配	assemble	fabricate	doctor
偷偷地行动：秘密、不显明地行动、发生或消失	steal
臆测	guess
成方形	square
懂	understand
&拉紧	strain
（使）相互磨擦	rub
收紧	gather
弯曲成一角度	angle
企图（做）	purpose
&（使）变凉	cool
驾驭	rein
向…供应帐逢	tent
（给词、短语等）下定义	define
驱逐	eject	out	expel
（使）原地转圈	roll
提防	beware
变化	move	range	vary
催逼	crowd
驾驶	fly	pilot	steer
分阶段实行	phase
回嘴	retort
踢（腿）	kick
编结	knit
请求	apply	ask	demand	demand	desire	petition	pray	sue	wish	invite
架桥于…之上	bridge
收到	collect	harvest	receive
编织	knit
拟稿	draft
编组	organize
乱塞	shove
把…储藏在房内	house
<口>忍受	swallow
（使）塌陷	cave
把…丢入字纸篓里	basket
用球拍打	racket
浸没	drown
折转	reflect
给…赎罪	purify
怜爱	caress
过得快	fly
讹诈	blackmail
用光	expend
播（种）	sow
足够	suffice	do
形成或分成层次	layer
发掘	dig
肿胀	swell
塑造人物	characterize
打呵欠	yawn
给予更多的支持	reinforce
画十字于	sign
简化	compact	simplify
使完婚	wedding
必要	want
念	say
用耙耙平（耕地）	bush
偷带	smuggle
在…植树造林	wood
自豪	glory	pride
叠拢	shut
拔出	drawing
请…喝酒	wine
（尤指通过加热使黄油）纯净	clarify
减价	discount
把…放在台上	platform
留下印象	register
使后退	back
用双手触摸、举起或握住	handle
制表	table
使竖起	erect
给…加姓	surname
使显现	manifest
给…注射	shoot
再发生	recur
理解	comprehend	discern	follow	perceive	read	reading	see	sense	understand	understanding	understanding	understanding	interpret
纪念	commemorate	remember
补足	complement
使…明显的	breathe
拒绝受理	dismiss
用…进行投机	venture
熔化	melt	melt	fuse
展示	celebrate	demonstrate	open	parade
愚弄	cheat	fool	mock
驻扎	hut	station
（用拖鞋）打（孩子等）	slipper
强迫吸收	pound
&收割	reap
挤在一起	huddle
证明…有罪	convict
逐渐降低	slide
鱼贯而行	stream
把…对折	middle
招降	summon
〈口〉争吵	row
把…吓跑	scare
祝酒	pledge
下来	descend	down
移植	transplant
使（学生）升级	promote
举止像猪	pig
（使）适合	fit
逃亡	desert
吸引	attract	draw	draw	fetch	gain	lure	sex	tempt
漂洗	full
单足蹦跳	hop
衰败	decay
贮存	save	squirrel
确立或使安全	establish
学到	acquire
利用（…为自己谋利）	exploit
（使）充满	fill
养护	condition
切开摊平	butterfly
应受	deserve
涂上	wipe
变瘦	thin
扩充	enlarge
借出	loan
极力贬低（某事物）的价值[重要性]	minimize
包裹	lap
穿着	dress	wear
给（马）配上挽具	tackle
谈	speak
削尖	point
绕开	skirt
交流	interface
（在书、音乐或作品的前部）题献辞	dedicate
倾覆	tip
运用舌法发音	tongue
使限于	throw
控制	beat	bottle	command	conduct	control	dictate	dominate	govern	operate	regulate	rule	steer
得到（一定数目的）选票	poll
服从	obey	submit
包装	pack	package	package	packet	paper
使激增	balloon
疏通）	approach
有节奏地驱动（机器等）	pulse
悬浮	suspend	suspend
（从…中）提取	derive
获得…专利	patent
做客串	guest
征收关税	tariff
查找	seek	trace
涌起	comb
拿下	remove
[金融业]（货币）交换	exchange
[英国英语]实行抵制（以抗议雇用非工会工人或声援工会工人罢工）	black
逮捕	arrest	lag	seize
教授	teach
（使）散开	disperse	scatter
〈美俚〉骗	bucket
及格	pass
意见相合	agree
培育	nurse	nurture
驾驶（船）	sail
住帐蓬	tent
呼喊	shout	exclaim
任（职）	serve
被修饰	modify
用栅栏围	pale
积极从事	practise
打破	break
抱有	hug
口干掉	eliminate
被关在畜舍内	stable
宴请（某人）	feast
消瘦	peak	pine
使偶合	twin
反弹	bounce	rally
&作为…的序言	preface
使终结	terminate
开除	remove
使某物竖起	cock
[航海]用拖船拖曳	tug
使顺从	conform	submit
有害	hurt
分隔	burst	compartment
有家	home
维护	assert	maintain
[计算机科学]引导	boot
为…理发剃须	barber
怀有	cherish	entertain
逼入困境	corner
把…作成截面	section
分手	separate
灼热	glow
使…美味	enrich
（用语言）表达	clothe	clothes
排成列	dress
报账	account
使挫伤	bruise
用橡胶制造	rubber
拨火	poke
伤	wound
（从隐蔽处）出现	peep
幻想	fancy	fantasy	vision
责备	quarrel	rail	reproach	tax
擦过	brush	glance	graze
使具备	equip
伐	chop
发红或发亮	flush
绘画	paint	paint
供给(provide的过去式和过去分词)	provided
实践	practice
突然（发出巨响	explode
将…藏于掌中	palm
支付	meet	pay
完全符合	register
向…供应	serve
欺骗	cheat	fool	fool	fox	jazz	kid	sell	skin	trick	impose
提请注意	appeal
（感情）流露	register
逐渐变化	shade
祝愿	pledge	wish
使受协议条款的约束	article
追逐	chase	course
奴隶般地工作	slave
出类拔萃	shine
使失宠	disgrace
[摄影术]显影	develop
（朝某方向）迅速移动	hurry
看来好像	seem
拒付	bounce
给…上发条	wind
填塞	choke	pad	plug	stuff
起刺激作用	stimulate
当然	bet
犯过错	sin
搭上	tail
老化	grey	perish
由此产生	follow
渐增	pyramid
放肆地投入	fling
[棒球、板球等]担任外场员	field
性交	couple
[口语][拳击]靠判定击败（对手）	decision
大量存在	abound
下（客）	discharge
在…上撒面包屑	bread
呼哧地吸气	sniff
变坚挺	strengthen
使兴奋或得意	flush
变差	suffer
命令	bid	call	command	command	command	dictate	dictate	order	require	instruct
乘船	boat
恼火	anger	anger
使等同于	match
束缚	bound	chain	curb	hamper	restrict
转移注意力	divert
疾行	race	steam
成功地用性勾引某人	score
（使）集合接受检阅	parade
回忆	recollect	think
用水清洗（尤指身体部位）	bathe
裹上	wrap
对…有重大关系	import
从…接受学位	graduate
表达	communicate	convey	couch	frame	put	reflect	register	voice	express
感染	permeate	infect	influence
如姐妹般相待	sister
测得结果	test
购物	shop
around等连用）	wrap
引导	channel	conduct	lead	shepherd	steer
悔过	confess
撒布	sprinkle
编码	code
提取岩芯（样品）	core
（尤指宗教或政治信仰的）迫害	persecute
点缀	decorate	dot	star
占领	occupy	seize	ascend
（使）落下	drop
拨准（钟、表）的快慢	time
绘制	design
发给证明书	certificate
套出	milk
给（刀刃）磨边	edge
满足…的需要	suffice
令失望	chill
打电报向（某人）发指令	telegraph
喜好	love
见证	witness
[印刷术]校对	proof
发出光与热	beam
擦灰	dust
以为	believe	consider	deem	esteem	feel	presume	think	thought
为…喝彩	cheer
使均一	uniform
使明白	convince
诉苦	complain	plain
英俚吃	tuck
变成	become	become
使移居	migrate
根源在于	root
开垦	reclaim
生产	born	make	manufacture	produce	yield
[数]有与…共同的某物	overlap
领会	appreciate	comprehend	saw	see	sense	understand
为…中最突出的事物	highlight
加重于	weight
变模糊	mist
培养(train的现在分词)	training
嘲弄	mock	monkey	trifle
使一致	conform	tune	unify
给…提供服装	costume
（议会、委员会、法庭等）开会	sit
累积而成	add
合身	fit	suit
使紧张不安	excite
险胜	shade
（给…）注射（药物等）	inject
试图贿赂（或影响	approach
激烈争辩	dispute
（为…）掷硬币决定	toss
悄悄地爬行	snake
射杀	pot	shot
浸水	dip
驳倒	refute	explode
宣告	proclaim	report
合唱	chorus
发挥	amplify	exert
击落（敌机等）	down
使兴奋	heat	hot	stimulate	warm	excite	irritate
冲淡	dilute
不在乎	smile
邻接	neighbor
（吸毒者随年龄增长而主动）戒毒	age
分乐节（尤指为奏乐或歌唱）	phrase
使有球形突出物	knob
弄整齐	tidy
盖邮戳	frank
拼命工作	strap
着陆	ground
惭愧	blush
飞行（…小时）	log
挺过	survive
置诱饵于…	bait
[采矿]汰选	concentrate
放在中间	middle
使绝缘	insulate
猛攻	rush	storm
阻止…的生长（或发展）	suppress
减轻体重	reduce
吝惜	pinch
但愿	wish
退步	lapse
除掉	eliminate	flush
把鞋型插入（鞋内）	tree
给…门票	ticket
呈球形	ball
履行	perform	satisfy	execute
进餐	dine	meal
拘留	detain
使蜷曲起来	huddle
涉及	concern	concerning	cover	relate
使更结实	reinforce
制造脏乱	mess
使具有某种结构	texture
记忆	recollect
摸索（路）	grope
使具有银色光泽	silver
点头示意	nod
用足尖跳舞	toe
能认出	know
去掉	shift
把…搅乱	scramble
显现	appear	develop	open	show
[语]构成	compare
总计	foot	sum
变馊	sour
即席圆满回答	field
塞满	burst	stuff
疏散	evacuate	evacuate
鼓动	encourage	agitate
实行	practice	practice	wage	exercise
（目光）闪耀	snap
适于上演	stage	stage
电影	cut
婉辞剽窃	abstract
撤销	avoid	retreat	undo	abolish
鼓励	encourage	heart	nerve	rouse	sanction	waken
炒（蛋）	scramble
胡乱堆积	lumber
使做曲线运动	swing
用砖围住或堵住	brick
钳子	bite
（角色、戏等）能被（扮）演	act
（巧妙地）捕获	net
在…之上	precede
不足	fail
（门窗等）闩上	bolt
使严肃	sober
低估	underestimate
置于中央	centre
统率	officer
作为…的首领	head
给…打气	pump
投标	bid	bid
提高（土地、地产）的价值	improve
翻滚	roll
使沉淀	evaporate	settle
当管事	steward
（数量）增加	rise	rose
把…包括在内	add
煞有介事地讲	fable
立定	halt
当首领	boss	captain
供…作食物	feed
使进入（某状态）	send
拜访	visit
使…散开	shatter
慢慢向前移动	edge
精查（证据）	riddle
来（尤指相聚、往某地	come
清偿（债务）	solve
用血染（皮革等）	blood
有重大影响	matter
吹喇叭	trumpet
给…装上杆柄	shaft
异常气愤	boil
惊吓]	shake
将…分解成因子	factor
弯曲	curve
尝	taste	touch
举行宗教庆典	celebrate
借钱	borrow
返回	return
增加	augment	boost	contribute	enhance	gain	lend	mount	push	push	up	add	add	advanced	extend	grow
变为	become	wax
贡献出	contribute
[网球、羽毛球]发球	serve
制作模型	model
讲解	explain
当间谍	spy
把…记入航海日志	log
对…做出刺或戳的动作	stab
使诧异	surprise
洗去罪名	wash
发出滴答声	tick
拥进	pack
钓到（鱼）	land
报时	striking
弄上污渍	spot
退缩	shrink
谈判达成	negotiate
使停止	halt
假定	guess	presume	suppose	assume
继续存在	persist	exist
告密	rat
[语]一致	agree
（猎犬等）跟踪搜寻	quest
做交易	bargain
捕鲸	whale
把…四舍五入	round
使跌落	spill
盖印	blank
康复	mend
把…放在或设在（基地）	base
分值是	score
成为同等	coordinate
（使）降低	drop	lower
使背井离乡	exile
借	borrow	loan
倚	lean
感到刺痛	smart
〈诗〉作诗	sing
（在海上）迫降	ditch
倒	pour	pour
为…接通电话	connect
跨入	step
剪下报刊上的文章（或新闻、图片等）	clip
镜子破裂了	crack
对…进行仔细调查	prospect
给（如管风琴音管）整声	voice
倾	pour
不信任	suspect
听取	hear
追赶	chase	pursue
使发展	evolve
强力实现	bull
（衣服、布料等）搭配	coordinate
逐步扩大	escalate
审问	examine
着手进行	launch
用舌吹	tongue
剪辑（影片	edit
迅速增长	mushroom
给…作演讲	lecture
珍爱	cherish
用于母马	horse
作出决定或达成协议	conclude
（朝一目标）努力争取	drive
被搓揉	twist
陈列	display	exhibit
[生]通过进化进程发展或发生	evolve
调和	average	compound	gear	temper
焦虑	tremble	tremble	worry
消散	lift	dissipate
给…编索引	index
建运河	canal
有联系	relate
纺（线）	spin
喻为	compare
阻挡	withhold
使移植	migrate
使用	employ	manage	occupy	use	utilize	access
说起	mention
把…分区	district
提出…作反对的理由	object
（汽车或自行车）（尤指不用动力向山坡下）滑行	coast
锚等）咬住	bite
明了	penetrate
给…铺床单	sheet
设宴款待	dine
用犁耕田	plough
照X光	X-ray
挡住	ward
铸成合金	alloy
在…写姓名地址	address
战斗	conflict	contend	fight
（用水）扑灭（火焰等）	quench
进行检查	inspect
使…与另一个匹敌	fellow
阿谀	flatter
抛弃	cashier	desert	discard	fling	quit	reject	scrap	abandon	ditch
涌往	swarm
用钩捞取	fish
当海盗	pirate
用火炉烤	stove
蓬勃	flourish
[生物学]（细胞）减数分裂	reduce
节食	diet
紧缩	contract
接纳…避难	refuge
给…看	show
扫过	sweep
用手肘推开	elbow
相称	become	blend	suit
（下级对上级的）请求	request
使惊讶	astonish
赞颂	credit	salute
放毒于	poison
终了	conclude	finish
给…提供住处	home
张望	quiz
同样看待	equal
招摇	pose
吵架	fight	scrap	dispute
给（书、讲话等）润色	lace
用开水煮	boil
瞎忙一气	fuss
使先取得经验	blood
表明…间的差别	differentiate
使（血液）发生血球溶解	lake
运用	apply	use	exercise	exert
制成药丸	pill
以苔藓覆盖	moss
（警方）通缉	want
使倒塌	collapse
（计算机屏幕上）显示	display
录像	video
把…打扮漂亮	doll
变成废墟	ruin
讲人坏话	talk
形成河道	channel
似将发生	threaten
用缎带装饰	ribbon
卷	reel	twist
尝试	attempt	endeavor	essay	make	experiment
用手掂估	weigh
盛行	prevail
用草覆盖	grass
关闭	close	shut	shut	shutter
协调	blend	coordinate	sort	tune
（使）繁殖	multiply
做好思想准备	prepare
在…装窃听器	bug
使中圈套	web
免除（自己的义务、负担等）	discharge
使结冰霜	frost
保卫	defend	guard	protect	safeguard
深深吸入	sniff
奏出	blow
麻痹某人对…的意识	drown
停止开放[营业]	shut
落后	drag	lag
使整合	integrate
生存	breathe	live	exist
反应	react
践踏	tramp
使成正方形	square
大发牢骚	beef	create
堕入	lapse
使从事	embark	occupy
滑冰	skate	ski
支撑	bear	born	brace	carry	manage	persevere	shore	support	sustain	uphold
口惨败	massacre
疏于照顾	neglect
（使）松弛	relax
比得上	compete	equal	peer
使变浅	shallow
[计]检索	retrieve
呼吸	breathe	breathe
关住（俚语）抓住	pin
[宗教]（因行善而）应得（善报）	merit
防护	arm	fence	safeguard
铭刻于	brand
阻止	arrest	block	choke	forbid	halt	obstruct	preclude	prevent	prevent	prohibit	stem	interrupt	keep
穿（孔）	bore
交往	cotton	sort
回答	counter	respond
自船上卸下	land
（使）增速	accelerate
载运用有轨电车运送（乘客）	trolley
使变脆弱	tender
类似	echo
产卵	lay
用帐蓬遮盖	tent
[法]召唤	demand
在预算中拨款给	budget
使熄灭	out
十分惊慌	panic
抱反感	object
核实	verify
用（力）	exert
预示	forecast	predict	shadow	signify	indicate	inform
推却	refuse
结冰	freeze	ice	ice
产生（效果）	effect
提供货物	stock
用面具遮住	mask
报导	cover
俚狂欢	howl
打盹儿	doze
下麻醉药	drug
错过（机会）	miss
检测出	sense
升起	hoist	lift	rose
突然说出	bolt	rap
游戏	play	sport	sport
曲折行进	worm
比得上某人	rival
使…快速移动	run
遂愿	attain
使稳定	anchor	steady
担任会议主席	preside
猎取	hunt
怜悯	sympathize
成团卷起	volume
〈非〉对…无礼	sauce
（把门、窗等）闩上	bolt
缓慢消失	linger
挨过	weather
（使）饥饿	hunger
阻抑	damp
卧倒	down
登记	book	catalog	enroll	enter	register	register
装入	pile
越过…的界限	exceed
压印	tool
[数]与…相切	touch
给…以荣誉	crown
屈辱	humiliate
买卖奴隶	slave
断裂	crack	separate
特性等）	clothe
踏上	step
归属	assign
使（神经等）错乱	disorder
傻笑	giggle
使受挫折	frustrate	mock
违背（原则）	compromise
生根	root
疼痛	hurt	smart	ache
自尊心等）	injure
护卫	escort
沟通	network
记账	charge
不复存在	disappear
[工]用接合板连接[加固]	fish
说明	clarify	demonstrate	say	show	explain	imply
不包括	exclude
[棒球]滑垒	slide
掺杂	blend
把…弄残废	lame
不准许	prohibit
消化	assimilate	digest	digest
期满	expire
螺丝	bite
预料会做（某事）	ought
形成…的边沿	rim
凹陷	pit
夏季放牧（家畜）	summer
是	be
使纯净	purify
对付	cope
统一	consolidate	consolidate	unify	unite
使萧条	depress
随季节而移居	migrate
用力投掷	hurl
不认真地考虑	toy
相比	compare
[棒球、板球等]按（或截）（球）	field
要求	ask	ask	demand	desire	exact	require	require	wish	expect
蜂拥进入	mob
宣判有罪	convict
本意是	mean	means
牢记	remember
使受影响	infect
安静下来	calm	quiet
款待	guest	host	treat
把…分类	bracket	range	rank	sort	distribute
喊出名字以寻找	page
（引擎等）发噗噗声	cough
快速旋转	spin
给…增加趣味或风味	sauce
堆起	pile
抽签决定	ballot
给…套上颈圈	collar
做针线活	sew
用铰链连接	hinge
干扰	annoy	invade
（有效地或成功地）处理	deal
随便提到	glance
（使）倾斜	heel	lean	incline
用美人斑装饰（脸）	patch
给出命令	command
用膝盖碰	knee
使和缓	moderate
使倾向于	bias	dispose
钩	hook
屹立	soar
重新获得	recover
促进	boost	encourage	facilitate	forward	foster	progress	promote	prompt	accelerate	advantage	aid	further
承包	contract	farm	job
设宴招待	banquet
用尖物刺穿（物件）	probe
紧跟	tag
连续敲叩	rap
假设	premise	presume	say	assume
告诫	warn
使变弱	reduce
用绳子系牢	rope
把…分格	panel
提供做…的权利[措施]	enable
为…提供场所	site
导致	breed	bring	lead	preface	result	spell	account	cause
膨胀	balloon	balloon	belly	bunch	puff	puff
把…置于城堡中	castle
为…洗盆浴	tub
常用于否定、疑问及条件句中]	care
（食品）保持新	keep
使（身心等）失调	disorder
（使）排队	queue
担当管理人	administer
out	set
使长眠	rest
崇拜（尤指达到看不到缺点的地步）	worship
沿…曲折前进（或延伸）	snake
反感	revolt
发抖	shiver	tremble
排解（争端等）	reconcile
搭起	pitch
给…装袖子	sleeve
销毁	rubbish
以金属覆盖	metal
装上百叶窗或以百叶窗关闭：	shutter
在…任节目主持人	anchor
凑合着活下去	manage
下阵雨	shower
用汤匙舀取	spoon
涌流	pour	well
换衣服	shift
采（煤等）	pool
掌握财政	finance
发表	appear	deliver	emit	publish	sound
固着	fix
（使）沸腾	boil
变紧密	compact
令人讨厌	annoy
试图夺取或攻克（堡垒、要塞等）	attempt
给…定名	entitle
（兔子似的）聚拢在一起	rabbit
发行	publish	release	issue	issue
尤指不期而遇	encounter
使满意	content	flatter	please	pleasure	satisfy	satisfy
专攻	major	major	specialize
投阴影于	shadow
穿行（以避开障碍）	weave
倚赖	rely
遗弃	leave
[无线]调谐	tune
决定	conclude	decide	decide	determine	elect	name	resolve	seal
（疾病）侵袭	affect
（使）散布	spread
推进（一段距离）	gain
拖拽	drag
用线标出	line
使瓦解	collapse	overthrow	disrupt
发生故障	jam
使惊奇	awe	surprise	amaze
储藏	squirrel	store
挣扎	tug
给…造址	site
沉溺于	bury
超速	speed
有助于	benefit	help
扣紧	fasten
调解：充当调解人	intermediate
（使某物）叠缩	telescope
疲乏	flag	weary
相互作用	interact
分岔	part
发热或变得发热	fever
暗中监视	spy
按某路线发送	route
给…装弹	shot
创立	construct	erect	organize
学会	learn
榨出	crush
使现代化	streamline	update
染上或粘上（颜色）	dye
做广告	advertise	advertise
施惠于	oblige
非常喜欢	adore
谅解	understanding
蒙蔽	blind
任课	tutor
使熟悉	acquaint
绕轨道而行	orbit
起身	arise
被（烟、感情等）熏[压]倒	overcome
说教	preach
使沉浸	submerge
得到增援	reinforce
贴	hang
装上齿轮	gear
使受折磨	kill
振翼	clap
[印]给…制铅板	plate
打招呼	hail	salute
削弱	break	lower	undermine
回旋	whirl
（使）偏向	incline
消灭	destroy	rubbish	vanish	abolish
使昏厥	stun
滑落	slide
用拉链拉上或扣上	zip
给予…标记（或徽号）	badge
变清澈	clear
运动	motion
变淡漠	dim
使遵守	conform
使…正式就职	install
遇到	confront
拈阄	lot
捕获	bag	tangle
[橄榄球]触地得分后得附加分	convert
装饰	array	deck	decorate	decorate	enrich	hang	ornament	trim	invest
谈情说爱	romance
使相等	equal	even
付给报酬	fee
落下	fall	sprinkle
审视	eye	scope
建立基础	bottom
使不得不应付	land
用盐渍	salt
使适合	accord
宣布…作废	void
购买	buy	purchase
投合	cater
（动物）凶狠地攻击（或伤害）	savage
正希望	wish
价格稳定	rule
犯罪	commit	sin	sin
升高	breast	raise
扩大	amplify	augment	build	enlarge	add	extend	grow
[机械学]转位	index
偶然听到	overhear
敲詐	sponge
耕种	farm	till
修补	mend	patch	piece
给…镶边	band	border	rim
使挥动	tremble
葬	bury
贸易保护	protect
砰地敲[推	bang
（把烛芯浸在融蜡里）制造（蜡烛）	dip
决定（某物）的位置以使其平衡、平稳或水平	true
使欣喜若狂	transport
声音（不自觉地）由…发出	escape
给…编号	number
弯成钩状	hook
请	ask	pray
打断	interrupt
耸肩	shrug
感到诧异	wonder
喝茶	tea
威逼	bully
锁好	lock
夺去	deprive
加快…的速度	speed
〈俚〉勤苦工作	plug
进行(proceed的现在分词)	proceeding
对抗	cope	encounter
进行视察	inspect
成团块	ball
对折	middle
用光发出信号	flare
创建	establish
变得和蔼	relax
使…痛不欲生	shatter
到达底部	bottom
读	pronounce
非法剥夺	rob
隔开	separate
游览	visit
增强	amplify	augment	rise	swell	increase	increase
吃饭	dine
不情愿	hesitate
使昏聩	blind
平息（吵架等）	patch
垛	stack
（乘渡船）渡过（河等）	ferry
垂	flow
夹痛	pinch
给…添加木柴	wood
把…视为圣徒	saint
（使）漂浮	float
丢	throw
出疹	erupt
使经得起考验	harden
焦急	sweat
牧（羊）	shepherd
担任守队队员	field
作王后（或女王）	queen
以有…而自豪	boast
发生矛盾	contradict
打（眼）	drill
援助	assist	assist
抹泥	mud
把…弄结实	compact
欲望[后接不定式	care
召回	recall
耗尽	consume	dissipate	exhaust	expend
（使）集中	focus	mass
形成顶部	top
转弯	swing
把…照亮	highlight
（使）摇荡	swing	toss
鸟嘴相接触	bill
登上（飞机、汽车、火车等）	hop
用…作交换	traffic
必须对付（某情况）	face
漏掉	miss
使暖和	toast
买通	buy
晒成棕褐色	tan
侵扰	intrude
不一致	jar
使接近	approximate
注销	cancel
参加竞选	campaign
用键盘输入	keyboard
使谦恭	humble
请示宽恕	excuse
使和谐一致	accord	agree
遗憾	regret	sorrow
翻阅	consult	thumb	thumb
使活泼	jazz
投邮	mail
使满足	content	suffice	indulge
使泛滥	flow
招聘	recruit
一见如	click
写(write的现在分词)	writing
并有	unite
规定	define	prescribe	prescribe	provide	require	rule	state
施予	deal
落实（政策）	implement
打出小孔图案	pink
用套索抓捕（动物）	rope
表扬	cite	commend	pat
训练	breed	coach	coach	discipline	drill	educate	prepare	programme	school	teach	train	training	exercise
挥霍	riot	dissipate	dissipate
树或花草结果	fruit
使不安	agitate	disturb
使…不安	bother
使困惑	confuse	fox
切片	carve
跨过	stride
使焦急	torture
经过努力到达某事物	attain
相融	merge
撒开	scatter
希望等）闪现	ray
活下来	survive
停留	continue	stay
循环	cycle	cycle
略进（饮食）	taste
面向别的事物	front
（用丫形杖）探测（地下水）	divine
蜕皮	shed	shed
使规格一律	uniform
修整	barber	edge
用公共汽车运送	bus
削减	cut	lower	trim	dock
渐渐进入	sink
迷恋	spoon
判断	diagnose	gauge
划分成带	zone
怀抱（希望、怨恨）	nourish
作包工	job
碰伤	bruise
定位于	pitch
加标点于	point
饿死	starve
损伤…的髋部	hip
用木料支撑	timber
敬佩	adore
斗争	contend	fight	strive
博得	earn
辩解	warrant	allege	explain	explain
再生	revive
装设	appoint
刺、扎	pink
装订	bind
作指导	coach
满足	fill	meet	satisfy	indulge
使悲伤	grieve
充溢着	swim
为…敲丧钟	toll
衰老	fade
提名	propose
露齿笑着表示	grin
使复原	restore
出版…的著作	publish
缺少	lack	want
分离（混合物）	separate
播种	seed
使参与	interest	involve
考验	test	try
突降	plunge
把…塞入	bundle
通过	pass	travel
是…的典型	exemplify
以杆推进	pole
传达	communicate	convey	relay
严厉地折磨、责打或责备	whip
似乎	seem
驳斥	challenge	contradict	refute
投掷	cast	heave	throw
使适应特殊情况	specialize
修正	polish	revise	update
反抗	react	withstand	withstand
吃光	consume	finish
委派	appoint
探索	grope	probe	quest	trace	trace	explore	explore
传输	transmit
闭上（嘴等）	shut
否决	veto	veto
以…为食	feed
使恢复健康	mend
装备（防御工事）	arm
把…弄红	ruby
铺设铁路	railroad
演绎	deduce	deduct
使免除	exempt
明白	know
擦掉	erase	erase
（在…上）开腰槽	gain
合法地被授予	vest
发动	launch	spark
使无效	flaw	void
幸存	survive	survive
使纯洁	purify
团结在一起	bond
使就座	seat	sit
（卡通制作）顺利接合	fair
关照	notice
结果	born
组织	conduct	form	mobilize	organize	streamline
提升	elevate	lift	prefer	promote	upgrade
将滑艇拖到小屋前面的岸边	beach
以花园装饰	garden
成金字塔状	pyramid
使惊跳	startle
缺席	absent
控告	law	law	prosecute	sue
向…发信号	signal
围以墙	wall
阻挠	frustrate	prevent	stop
欢闹	bubble
复习功课	review
长肥	fat
仿造…的样式或图案	copy
[永世受罚	damn
接近	amount	verge	access	access	approach	approach
使不得不	compel
指挥划桨	stroke
电购	telegraph
处决	execute
（牛马、骆驼等）撒尿	stale
使付出努力	cost
使极端贫困	bankrupt
给…装肋材	rib
吱嘎声：因压力而发出声响	groan
得意	glory	pride	puff
严厉谴责	lash
对（某事物）表示[感到]怀疑	question
注射	shot
生殖	reproduce
加温	warm
长出新枝	stool
被忘掉	escape
重申	renew
经受住	last	abide
（使）大量落下	rain
嵌套	nest
具重要性	import
削价出售	discount
低语	breathe
显示出…时代（或年龄）	date
为…伴奏	accompany
永不停止的过程	cease
（因好奇而）逛贫民区	slum
使暗	shut
（骑马、自行车等）穿越	ride
标定方向	orient
动摇	balance	shake	stagger
盛产	abound
叫回	recall
[乐]减半音	diminish
详尽说明	elaborate
授予…奖章（或徽章）	badge
建议	counsel	propose	proposition	recommend	submit	suggest	advise	advise
使成缺口	gap
使有准备	equip
勘查	map	explore
磨光	grind	finish
建设	plant
把…括在一起	bracket
渐渐变为（与into连用）	graduate
取	take
吸引住：吸引…的兴趣或注意力	grip
用外衣遮蔽	cloak
布道	preach
空谈	gas
变得清楚	clarify
回避	duck	hedge
上（船、车或飞机）	board
故意少给…的零头	short
彻底搜索	sweep
懂得	possess	understanding	understanding
安置	deposit	position	set	station	install
深思	chew	consider	meditate
聚众包围	mob
懒洋洋地打发（时间）	lounge
使变成灰色	grey
取出…的内脏	gut
把…编制	assign
禁食	fast
可得到	wait
使无精神	oppress
拯救(save的现在分词)	saving
详细分析	labor
扔成一堆	heap
使合在一起：封合	fasten
（使）均衡	balance
坠落	crash
尾随	shadow
作注解	comment
假造	doctor
惊跳	startle
发出火焰	flame
行走	step	walk
花（时间）	spend
当祖母	grandmother
呵斥	snap
使团结在一起	lump
煽动	egg	hound	lash	provoke	sow	agitate
揭掉	peel
重返	resume
干	do
镀锡	tin
鉴定…的年代	date
打破（纪录）	break
以…为枕	pillow
丛生	bush	cluster
使带上色彩	color
为…忧虑（或担心、焦虑）	fear
程序]	route
（价格）上涨	strengthen
谈论	comment	discourse	talk	discuss
给予财富	fortune
象征	embody	represent	indicate
冲蚀	undermine
寄存	deposit	lodge
使气馁	discourage	oppress	dismay
培养	culture	educate	foster	programme	train
使减弱	damp
提醒	remind
款待（某人）	feast
走岔路	fork
来源于	descend
小声说	murmur
为…加旁注	margin
跳过	jump	leap	over	skip	spring
煨	jug
煮	cook
使生根	root
